disease_en	disease_jp
sickle cell disease
Lewis lung carcinoma
pancreatic carcinoma
colon carcinoma
papillary thyroid carcinoma
abdominal angina	腹部狭心症
abdominal aortic aneurysm	腹部大動脈瘤
abdominal bleeding	腹部出血(abdominal hemorrhage)
abdominal epilepsy	腹部癲癇
abdominal face	腹膜炎顔貌
abdominal fullness	腹部膨満
abdominal hemorrhage	腹部出血(abdominal bleeding)
abdominal pain	腹痛(abdominalgia)
abdominal trauma	腹部外傷
abdominal tumor	腹部腫瘍
abdominalgia	腹痛(abdominal pain)
aberrant pancreas	迷入膵
aberrant salivary gland	迷入唾液腺
ablatio corporis vitrei	硝子体剥離
ablepharia	無眼瞼(症)
ablepsia	視覚消失(症)
abortion	流産
cancer
habitual abortion	習慣性流産
inevitable abortion	不可避流産
spontaneous abortion	自然流産
threatened abortion	切迫流産
abortive infection	不発感染∥不全感染∥頓挫感染
abrachia	無腕(症)
abscess	膿瘍
bursal abscess	滑液包膿瘍
cold abscess	冷膿瘍，寒性膿瘍
epidural abscess	硬膜外膿瘍
lung abscess	肺膿瘍
mammary abscess	乳房膿瘍
peritonsillar abscess	扁桃周囲膿瘍∥扁桃膿瘍(quinsy)
residual abscess	遺残膿瘍
subdural abscess	硬膜下膿瘍
subhepatic abscess	肝下膿瘍
abstinence symptom	禁断症状
abstinence syndrome	禁断症候群
acantholysis	棘融解
acanthoma	棘細胞腫
acanthosis	棘細胞症
acanthosis nigricans	黒色表皮腫(略 AN)
acanthosis nigricans maligna	悪性黒色表皮腫
acatamathesia	感覚性忘失
acheilia	無口唇[症]∥口唇欠損(症)
acheiropodia	無手足(症)(acheiropody)
acheiropody	無手足(症)(acheiropodia)
achillobursitis	アキレス腱滑液包炎
achillodynia	アキレス腱痛
acholia	無胆汁(症)
acholuria	無胆汁尿(症)
achondroplasia	軟骨無形成(症)
acidophilic adenoma	好酸性腺腫
acne	面皰∥アクネ/にきび/
acne rosacea	酒さ性痊瘡∥酒さ性アクネ
acoustic neuroma	聴神経腫
acrocephalosyndactyly	尖頭合指(症)
acromegalia	先端肥大[症]∥肢端肥大(症)(acromegaly)
acromegaly	先端肥大[症]∥肢端肥大(症)(acromegalia)
acromyotonia	四肢強直(症)
actinic cheilitis	日射性口唇炎
actinic conjunctivitis	照射性結膜炎(ultraviolet keratoconjunctivitis)
actinic keratitis	紫外線角膜炎
actinic keratosis	日光角化症(solar keratosis)
actinic retinitis	紫外線網膜炎
actinomycoma	放線菌腫
actinomycosis	放線菌症
actinoneuritis	放射線神経症
active hepatitis	活動性肝炎
active infectious tuberculosis	活動性感染性結核
acute anteroseptal myocardial infarction	急性前中隔心筋梗塞
acute aortic dissection	急性大動脈解離(略 AD)
acute apical periodontitis	急性根尖性歯周炎<[歯]>
acute appendicitis	急性虫垂炎
acute bacterial endocarditis	急性細菌性心内膜炎(略 ABE)
acute bronchitis	急性気管支炎
acute cholecystitis	急性胆嚢炎
acute chorditis	急性声帯炎
acute encephalopathy	急性脳症
acute eosinophilic pneumonia	急性好酸球性肺炎(略 AEP)
acute exanthema	急性発疹
acute gastritis	急性胃炎
acute gastroenteritis	急性胃腸炎
acute hepatitis	急性肝炎
acute inflammation	急性炎症
acute interstitial nephritis	急性間質性腎炎(略 AIN)
acute laryngitis	急性喉頭炎
acute mediastinitis	急性縦隔炎
acute myelogenous leukemia	急性骨髄性白血病(略 AML)
acute myocardial infarction	急性心筋梗塞
acute myocardial necrosis	急性心筋壊死
acute myringitis	急性鼓膜炎
acute nephritis	急性腎炎
acute osteomyelitis	急性骨髄炎
acute pancreatitis	急性膵炎
acute paranasal sinusitis	急性副鼻腔炎
acute pericarditis	急性心膜炎
acute renal failure	急性腎不全(acute renal insufficiency)
acute renal insufficiency	急性腎不全(acute renal failure)
acute respiratory distress syndrome 	急性呼吸窮迫症候群
acute sinusitis	急性洞炎
acute withdrawal syndrome	急性禁断症状
adamantinoma	エナメル上皮腫〈ameloblastomaの旧称〉
pituitary adamantinoma	下垂体エナメル上皮腫
addison's disease	アジソン病
adenitis	腺炎
adenocarcinoma	腺癌
adenoid cystic carcinoma	腺様嚢胞癌
adenoid squamous cell carcinoma	腺様扁平上皮癌
adenoma	腺腫
pituitary adenoma	下垂体腺腫
adenomatoid odontogenic tumor	腺様歯原性腫瘍
adenomatosis	腺腫症
adenomyoepithelioma	腺筋上皮腫
adenomyoma	腺筋腫
adenomyosis	腺筋症
adenomyosis uteri	子宮腺筋症
adenosarcoma	腺肉腫
adiposa dolorosa	疼痛性脂肪[沈着]症[L]
adipositas cordis	心脂肪過多[L](fatty heart//fatty infiltration of heart//steatosis cordis[L])
adnexitis	子宮付属器炎∥付属器炎
adrenalitis	副腎炎
adrenalopathy	副腎疾患
adrenomegaly	副腎肥大
adult T cell leukemia	成人性Ｔ細胞白血病
advanced cancer	進行癌
aerocele	気瘤(pneumatocele)
aerocolpos	膣気腫
aerodermectasis	皮下気腫(surgical emphysema)
aerodontalgia	気圧歯痛
agalactia	無乳(症)
agammaglobulinemia	無ガンマグロブリン血(症)
aganglionosis	神経節細胞欠損(症)
agenesis	無発生∥無発育
ureteral agenesis	尿管無形成
aggressive fibromatosis	侵襲性線維腫症
aglossia	無舌(症)
aglossostoma	無舌体
agnathia	無顎(症)
agnogenic myeloid metaplasia	原因不明性骨髄様化生
agnosia	失認症
agonadism	無性腺症
agranulocytosis	無顆粒球症
agrypnia	不眠(症)
akinesia	無動[症]∥運動不能
albuminuria	アルブミン尿[症]∥蛋白尿(症)
postrenal albuminuria	腎後性蛋白尿(症)
alcoholic fatty liver	アルコール性脂肪肝
alcoholic hepatitis	アルコール性肝炎
alcoholic polyneuritis	アルコール性多発性神経炎
alexia	失読症∥読字障害
algesia	痛覚過敏
algomenorrhea	月経痛
alimentary anemia	栄養性貧血(nutritional anemia)
aliquorrhea	髄液欠乏(症)
alkalosis	アルカリ血症∥アルカローシス
allergic conjunctivitis	アレルギー性結膜炎
allergic contact dermatitis	アレルギー性接触性皮膚炎
allergic diarrhea	アレルギー性下痢
allergic dermatitis	アレルギー性皮膚炎
allergic rhinitis	アレルギー性鼻炎
allergy	過敏症∥アレルギー
latex allergy	ラテックス過敏症
alopecia	脱毛症
alopecia areata	円形脱毛症(alopecia circumscripta)
alopecia circumscripta	円形脱毛症(alopecia areata)
alopecia hereditaria	遺伝性脱毛症
alveolar adenocarcinoma	肺胞性腺癌
alveolar cell carcinoma	肺胞細胞癌(略 ACC)
alveolar proteinosis	肺胞蛋白症
alveolar soft part sarcoma	胞巣状軟部肉腫∥蜂巣状軟部肉腫
alveolitis	肺胞炎
extrinsic allergic alveolitis	外因性過敏性肺胞炎(略 EAA)
alzheimer's disease	アルツハイマー病
amblyaphia	触覚鈍麻
amblyopia	弱視
amebiasis	アメーバ症
amebic colitis	アメーバ性大腸炎
amebic diarrhea	アメーバ性下痢
amebic dysentery	アメーバ赤痢
amelanotic malignant melanoma	無色素性悪性黒色腫
amelia	無肢症
ameloblastic fibroma	エナメル上皮線維腫
ameloblastic fibrodentinoma	エナメル上皮線維象牙質腫
ameloblastic fibro-odontoma	エナメル上皮線維歯牙腫
ameloblastic fibrosarcoma	エナメル上皮線維肉腫
ameloblastic sarcoma	#NAME?
ameloblastoma	エナメル上皮腫
malignant ameloblastoma	悪性エナメル上皮腫
amelogenesis imperfecta	エナメル質形成不全症
amelus	無肢体
amenorrhea	無月経
amnionitis	羊膜炎
amniorrhea	羊水漏
amniorrhexis	羊膜破裂
amorphus	無形体
amputation neuroma	切断神経腫
amyelotrophy	脊髄萎縮
amyloidosis	アミロイド症∥アミロイドーシス∥類澱粉沈着症
pulmonary amyloidosis	肺アミロイドーシス
systemic amyloidosis	全身性アミロイドーシス
amyotrophic lateral sclerosis	筋萎縮性側索硬化症(略 ALS)
anal atresia	鎖肛(imperforate anus//aproctia//atresia ani[L])
anal fissure	裂肛∥肛門裂傷(fissura ani[L])
anal fistula	痔瘻∥肛門瘻
anal prolapse	肛門脱∥直腸脱
anal ulcer	肛門潰瘍
analgia	無痛覚
anaphylaxis	アナフィラキシー
anaphase	後期
anaplasia	退行形成∥退形成
anconitis	肘関節炎
anemia	貧血
aplastic anemia	再生不良性貧血
hemolytic anemia	溶血性貧血
hypochromic anemia	低色素性貧血
iron deficiency anemia	鉄欠乏性貧血
normocytic anemia	正球性貧血
nutritional anemia	栄養性貧血
osteosclerotic anemia	骨硬化性貧血
pernicious anemia	悪性貧血
refractory anemia	不応性貧血[略 RA]
anemic polyneuritis	貧血性多発性神経炎
anetoderma	斑状皮膚萎縮症
aneurysm	動脈瘤
atherosclerotic aneurysm	粥状硬化性動脈瘤∥アテローム硬化性動脈瘤
dissecting aneurysm	解離性動脈瘤
mycotic aneurysm	真菌性動脈瘤
aneurysmal bone cyst	脈瘤性骨嚢胞
angialgia	血管痛(angiodynia)
angiectasis	血管拡張症
angiitis	血管炎(vasculitis)
angina pectoris	狭心症
anginal pain	アンギーナ痛∥狭心[症]痛
angiocarditis	血管心臓炎
angiocholecystitis	胆嚢胆管炎
angiocholitis	胆管炎
angiodynia	血管痛(angialgia)
angiofibroma	血管線維腫
angioglioma	血管神経膠腫
angioleiomyoma	血管平滑筋腫(vascular leiomyoma)
angioleiomyosarcoma	血管平滑筋肉腫
angiolipoma	血管脂肪腫
angioma	管腫
angiomatosis	血管腫症
bacillary angiomatosis	細菌性血管腫症
angiomyolipoma	血管筋脂肪腫
angiomyoma	血管筋腫∥血管平滑筋腫
angiomyxoma	血管粘液腫
angioneuropathy	血管神経症(vasoneurosis)
angiopathy	血管障害
angiorrhexis	血管破裂
angiosarcoma	血管肉腫∥管肉腫
angiotitis	血管性耳炎
anhydromyelia	無髄液(症)
anisocoria	瞳孔不同(症)
ankyloblepharon	眼瞼癒着(blepharosynechia; symblepharon)
ankylosing spondylitis	強直性脊椎炎[略 AS](=spondylitis ankylopoietica[L])
ankylosis	硬直
ankyloglossia	舌癒着症∥舌小帯短小
ankylocheilia	口唇硬直
anodontia	無歯症
anomaly	異常
chromosomal anomaly	染色体異常
anonychia	無爪症∥爪甲欠損(症)
anophthalmia	無眼球(症)
anopia	無眼球(症)
anorexia	食欲減退
anosmia	無嗅覚[症]∥嗅覚消失
anosphrasia	無嗅覚症∥嗅覚消失(anosmia)
anovulation	無排卵症
anovulatory menstruation	無排卵性月経
anoxemia	無酸素血症
anoxia	無酸素症(形 *anoxic)
anoxic encephalopathy	低酸素性脳症(hypoxic encephalopathy) 
anteflexion of uterus	子宮前屈
anterior poliomyelitis	脊髄前角炎
anthracopneumoconiosis	黒塵肺(症)(black lung disease)
anthrax	炭疽
antiperistalsis	逆蠕動
antral gastritis	前庭胃炎
anuria	無尿(症)
aortalgia	大動脈痛
aortectasia	大動脈拡張症
aortic aneurysm	大動脈動脈瘤
aortic arch syndrome	大動脈弓症候群(略 AAS)
aortic atresia	大動脈弁閉鎖(略 AA)
aortic stenosis	大動脈弁狭窄
aortitis	大動脈炎
aortosclerosis	大動脈硬化(症)
aphagia	嚥下不能(症)
aphakia	無水晶体(症)
aphasia	失語症
aphonia	失声症
aphthous gingivitis	アフタ性歯肉炎
aphthous pharyngitis	アフタ性咽頭炎
aphthous stomatitis	アフタ性口内炎
apituitarism	無下垂体症
aplasia	無形成
apnea	無呼吸(症)
apodia	無足(症)
aponeurositis	腱膜炎
apophysitis	骨端症
apoplexy	脳卒中
appendalgia	虫垂痛(appendicalgia)
appendicalgia	虫垂痛(appendalgia)
appendicitis	虫垂炎
apraxia	失行症∥行動不能症
aproctia	鎖肛(anal atresia; atresia ani[L]; imperforate anus)
aprosopia	無顔症
aprosopus	無顔体
apus	無足体
arachnoid cyst	クモ膜嚢胞
areolitis	乳輪炎
armwrestling fracture	腕相撲骨折
arrhythmia	不整脈
arteriochalasis	動脈弛緩(症)
arteriodialysis	動脈離開
arteriolith	動脈結石
arteriolitis	細動脈炎
arteriolonecrosis	細動脈壊死
arteriolosclerosis	細動脈硬化(症)
arteriomalacia	動脈軟化(症)
arteriomyomatosis	動脈筋腫症
arteriopathy	動脈疾患∥動脈症
arteriorrhexis	動脈破裂
arteriosclerosis	動脈硬化(症)
arteriosclerosis obliterans	閉塞性動脈硬化症[略 ASO]
arteriosclerotic heart disease	動脈硬化性心疾患[略 AHD]
arteritis	動脈炎
arthrectasia	関節腔拡張症
arthredema	関節浮腫
arthritis	関節炎
chronic inflammatory arthritis	慢性炎症性関節炎
gouty arthritis	痛風性関節炎
rhematoid arthritis	リウマチ性関節炎
traumatic arthritis	外傷性関節炎
uratic arthritis	痛風性関節炎
arthrocele	関節瘤
arthrochalasis	関節弛緩症
arthrochondritis	関節軟骨炎
arthroclisis	関節強直
arthrogryposis	関節拘縮症
arthrolith	関節結石
arthrolithiasis	関節結石症
arthrolues	関節梅毒
arthropathy	関節症
arthrosis	関節症
arthrosynovitis	関節滑液膜炎
asbestosis	石綿症
ascites	腹水(形 *ascitic)
aseptic meningitis	無菌性髄膜炎
aspergillosis	アスペルギルス症
aspermatism	無精液(症)(aspermia)
aspermia	無精液(症)(aspermatism)
asphyxia	窒息(suffocation)
aspiration pneumonia	吸引性肺炎∥嚥下性肺炎
asterixis	羽ばたき震顫(liver flap; flapping tremor)
asthma	喘息
cough variant asthma	咳喘息(略 CVA)
asthmatic bronchitis	喘息性気管支炎(略 AB)
asthenia	無力症
asthenopia	眼精疲労(eye strain)
astigmatism	乱視
astomia	無口症
astrocytoma	星状膠細胞腫∥アストロチトーム
astrocytosis	星状細胞増加[症]∥星状細胞増多(症)
asynchrony	非同時性∥非同期∥異期
ataxia	運動失調
atelectasis	無気肺
atelencephalia	脳発育不全
atelocheilia	唇発育不全
atelocheiria	手発育不全
ateloglossia	舌発育不全
atelomyelia	脊髄発育不全
atheroembolism	粥腫塞栓症∥アテローム塞栓症
atheroma	粥腫∥粉瘤∥アテローム
atheromatosis	アテローム症
atheromatous degeneration	粥腫性変性∥アテローム変性
atherosclerosis	粥状動脈硬化症∥アテローム性動脈硬化症
atmospheric hypoxia	大気性低酸素症
atopic asthma	アトピー性喘息
atopic dermatitis	アトピー性皮膚炎
atopognosia	感覚部位失認
atopy	アトピー
atresia	閉鎖症
biliary atresia	胆道閉鎖症
atresia ani	鎖肛[L](=anal atresia; imperforate anus; aproctia)
atresia of right atrioventricular orifice	右房室口狭窄
atrial septal defect	心房中隔欠損症[略 ASD]
atrophic emphysema	萎縮性気腫
atrophic glossitis	萎縮性舌炎(Hunter's glossitis)
atrophic laryngitis	萎縮性喉頭炎
atrophoderma vermiculatum	虫食い状皮膚萎縮症[L]
atrophy	萎縮
brown atrophy	褐色萎縮
disuse atrophy	廃用性萎縮
senile atrophy	老人性萎縮
atypical pain	不定疼痛
atypical adenomatous hyperplasia	異型腺腫様過形成[略 AAH]
auditory neuropathy	神経性聴覚障害
autoimmune hepatitis	自己免疫性肝炎
avascular osteonecrosis	阻血性壊死
avascularization	無血管化
avulsion fracture	剥離骨折
axanthopsia	黄色盲
azoospermia	無精子症∥精子欠如症
bacillary dysentery	細菌性赤痢
back lump	背部腫瘤
bacteremia	菌血症
bacterial food poisoning	細菌性食中毒
bacterial infection	細菌性感染
bacterial meningitis	細菌性髄膜炎
bacterial pneumonia	細菌性肺炎
bacterial pulpitis	細菌性歯髄炎
bacterial vaginosis	細菌性膣症
bad breath	口臭(halitosis)
basal cell adenoma	基底細胞腺腫
basal cell carcinoma	基底細胞癌
basal cell nevus syndrome	基底細胞母斑症候群
basedow's disease	バセドウ病
basilar artery aneurysm	脳底動脈瘤
basilar meningitis	脳底髄膜炎∥頭蓋底髄膜炎
battle fatigue	戦闘疲労
benign cementoblastoma	良性セメント芽細胞腫
benign intracranial hypertension	良性頭蓋内圧亢進症
benign lymphoepithelial lesion	良性リンパ上皮性病変
benign osteoblastoma	良性骨芽細胞腫
benign prostatic enlargement	良性前立腺腫大(略 BPE)
biconcave vertebrate	二凹脊椎
bicornate uterus	双角子宮
bidactyly	二指症
bile duct carcinoma	胆管癌∥胆管細胞癌(cholangiocarcinoma)
extrahepatic bile duct carcinoma	肝外胆管癌
biliary cirrhosis	胆汁性肝硬変(obstructive cirrhosis)
primary biliary cirrhosis	原発性胆汁性肝硬変
secondary biliary cirrhosis	二次性胆汁性肝硬変
biliary cystadenocarcinoma	胆管嚢胞腺癌
biliary cystadenoma	胆管嚢胞腺腫
biliary encephalopathy	胆汁性脳症
biloma	嚢内貯留胆汁
black lung disease	黒塵肺(症)anthracopneumoconiosis 
bladder injury	膀胱損傷
blastoma	芽細胞腫∥芽球腫∥芽腫
blastomycosis	醸母菌症
bleeding	出血(hemorrhage)
pontine bleeding	橋出血(pontine hemorrhage)
subdural bleeding	硬膜下出血(subdural hemorrhage)
blepharadenitis	眼瞼腺炎(blepharoadenitis)
blepharedema	眼瞼浮腫
blepharism	眼瞼痙攣(blepharospasm) 
blepharitis	眼瞼炎
blepharoadenitis	眼瞼腺炎(blepharadenitis)
blepharoadenoma	眼瞼腺腫
blepharoatheroma	眼瞼粉瘤∥眼瞼アテローム
blepharochalasis	眼瞼皮膚弛緩(症)
blepharoconjunctivitis	眼瞼結膜炎
blepharochromidrosis	眼瞼色汗症
blepharoclonus	間代性眼瞼痙攣
blepharophimosis	眼瞼縮小
blepharoplegia	眼瞼麻痺
blepharoptosis	眼瞼下垂(症)
blepharospasm	眼瞼痙攣
blepharosynechia	眼瞼癒着(ankyloblepharon; symblepharon)
bloody diarrhea	血性下痢
bone cyst	骨嚢胞
bone defect	骨欠損
bone fracture	骨折
bone infarction	骨梗塞
boring pain	穿孔痛
borreliosis	ボレリア感染症∥ボレリア症
lyme borreliosis	ライム*ボレリア感染症∥ライム*ボレリア症
bovine tuberculosis	牛型結核(症)
bow elbow	内反肘(cubitus varus)
bowen's disease	ボーエン病
brachycephaly	短頭症
brachygnathia	短顎(症)
bradycardia	徐脈
bradykinesia	運動緩慢
bradypepsia	消化緩徐
bradypnea	徐呼吸∥呼吸緩慢
bradysphygmia	徐脈
brain concussion	脳震盪(cerebral concussion)
brain contusion	脳挫傷
brain death	脳死
brain hemorrhage	脳出血(cerebral hemorrhage; hematencephalon; encephalorrhagia)
brain infarction	脳梗塞
brain metastasis	脳転移
brainstem hemorrhage	脳幹出血
brainstem infarction	脳幹梗塞
branchial cyst	鰓嚢胞
breast cancer	乳癌
breast carcinoma	乳癌
breast milk jaundice	母乳性黄疸
brevicollis	短頚症
bronchial asthma	気管支喘息
bronchial pneumonia	気管支肺炎(bronchopneumonia)
bronchial spasm	気管支痙攣(bronchospasm)
bronchiectasia	気管支拡張症(bronchiectasis)
bronchiectasis	気管支拡張症(bronchiectasia)
congenital bronchiectasis	先天性気管支拡張症
bronchiolar adenocarcinoma	細気管支腺癌(bronchiolar carcinoma)
bronchiolar carcinoma	細気管支腺癌(bronchiolar adenocarcinoma)
bronchiolitis	細気管支炎
chronic bronchiolitis	慢性細気管支炎
congestive bronchiolitis	うっ血性細気管支炎
bronchitis	気管支炎
chronic bronchitis	慢性気管支炎
bronchoalveolar carcinoma	気管支肺胞癌
bronchogenic carcinoma	気管支癌
broncholith	気管支結石
bronchomycosis	気管支真菌症∥気管支真菌感染症
bronchopneumonia	気管支肺炎
bronchospasm	気管支痙攣
brown induration	褐色硬化
bulbar bleeding	延髄出血(bulbar hemorrhage; hematobulbia)
bulbar hemorrhage	延髄出血(bulbar bleeding; hematobulbia) 
bullous pemphigoid	水疱性類天疱瘡
bursal hernia	滑液包ヘルニア
bursitis	滑液包炎∥滑液嚢炎
cacogeusia	異常味覚
cafe-au-lait spot	カフェオーレ斑
calcaneitis	踵骨炎
calcaneovalgus	踵骨外反(*扁平足にみる)
calcification	石灰化
dystrophic calcification	異栄養性石灰化
ectopic calcification	異所性石灰化
metastatic calcification	転移性石灰化
pathological calcification	病的石灰化
pulmonary calcification	肺石灰化
malherbe's calcifying epithelioma	マレルブ石灰化上皮腫(calcifying epithelioma of Malherbe)
calcifying odontogenic cyst	石灰化歯原性嚢胞
calcinosis	石灰症
calculus	結石(stone)
cerebral calculus	脳石
dental calculus	歯石
urethral calculus	尿道結石
canalicular adenoma	細管状腺腫
colorectal cancer	結腸直腸癌
gallbladder cancer	胆嚢癌
liver cancer	肝癌
lung cancer	肺癌
mammary cancer	乳癌
cancroid	類癌
candidiasis	カンジダ症
canker sore	口唇潰瘍
canthitis	眼角炎
carcinoid	カルチノイド
carcinoma	癌腫
carcinoma colli	子宮頚癌[略 CC]
carcinoma in situ	上皮内癌
cervical carcinoma	子宮頚癌(cervical cancer)
clear cell carcinoma	明細胞癌
epidermoid carcinoma	類表皮癌
large cell carcinoma	大細胞癌
mucoepidermoid carcinoma	粘表皮癌
renal cell carcinoma	腎細胞癌
small cell carcinoma	小細胞癌
squamous cell carcinoma	扁平上皮癌
verrucous carcinoma	疣贅癌
carcinomatosis	癌腫症∥癌多発症
cardiac hypertrophy	心肥大
cardiac pain	心臓痛(cardialgia; cardiodynia)
cardialgia	心臓痛(cardiac pain; cardiodynia)
cardiocirrhosis	心臓性肝硬変
cardiodynia	心臓痛(cardiac pain; cardialgia)
cardiogenic shock	心原性ショック
cardiomegaly	心臓肥大[症]∥心肥大
cardiopathy	心臓病∥心臓疾患
cardiopericarditis	心臓心膜炎
cardiophobia	心臓恐怖症
cardioptosis	心臓下垂症
cardiorrhexis	心破裂
cardiospasm	噴門痙攣
cardiovalvulitis	心弁膜炎
carditis	心臓炎
cardiomyopathy	心筋症
diabetic cardiomyopathy	糖尿病性心筋症
rheumatic carditis	リウマチ性心筋炎
carotid cavernous sinus fistula	内頚動脈海綿静脈洞瘻
carpal tunnel syndrome	手根管症候群(略 CTS)
carpoptosis	下垂手
caruncle	カルンクル
urethral caruncle	尿道カルンクル
caseous pneumonia	乾酪性肺炎
cataract	白内障
cuneiform cataract	楔状白内障
diabetic cataract	糖尿病性白内障
membranous cataract	膜性白内障
nuclear cataract	核[性]白内障
posterior subcapsular cataract	後嚢下白内障(略 PSC)
tetanic cataract	痙攣性白内障
traumatic cataract	外傷性白内障
catarrhal gastritis	カタル性胃炎
catarrhal inflammation	カタル性炎症
cauda equina injury	馬尾損傷
causalgia	灼熱痛
cavernitis	海綿体炎
cavernoma	海綿腫
cavernous sinus thrombosis	海綿静脈洞血栓
cecitis	盲腸炎
cecoptosis	盲腸下垂症
celialgia	腹部疝痛
cellular embolism	細胞性塞栓症
cellulitis	蜂窩織炎
cementifying fibroma	セメント質形成性線維腫
cemento-osseous dysplasia	セメント質骨異形成(症)
cemento-ossifying fibroma	セメント質骨形成[性]線維腫
cementum hyperplasia	セメント質増殖症(hypercementosis)
central deafness	中枢聾
central giant cell granuloma	中心性巨細胞肉芽腫
central retinal artery occlusion	網膜中心動脈閉塞[略 CRAO]
cephalalea	頭痛(headache)
cephalalgia	頭痛(cephalalgy; headache)
cephalalgy	頭痛(cephalalgia; headache)
cephaledema	頭部水腫
cephalopagus	頭部結合体
cephalopathy	頭部疾患
cephalothoracopagus	頭胸結合体
cerebellar bleeding	小脳出血(cerebellar hemorrhage)
cerebellar hemorrhage	小脳出血(cerebellar bleeding)
cerebellar infarction	小脳梗塞
cerebral concussion	脳震盪(brain concussion)
cerebral contusion	脳挫傷
cerebral hernia	脳ヘルニア
cerebral hemorrhage	脳出血(brain hemorrhage; hematencephalon; encephalorrhagia)
cerebral infarction	脳梗塞
cerebral meningitis	脳膜炎∥脳髄膜炎
cerebral thrombosis	脳血栓症
cerebral toxoplasmosis	脳トキソプラスマ症
cerebrosclerosis	脳硬化症
cerebrospinal fluid hypovolemia	脳脊髄液減少(症)
cerebrospinal meningitis	脳脊髄膜炎∥髄膜炎
cerebrospinal rhinorrhea	髄液鼻漏
cerebrospinal syphilis	脳脊髄梅毒
ceruminosis	耳垢症
cervicitis	子宮頚炎
cervicodynia	頚痛∥頚部痛∥頚筋痛
cervico-omo-brachial syndrome	頚肩腕症候群
chalazion	霰粒腫
chance hematuria	偶発性血尿
cheilectropion	口唇外反
cheilitis	口唇炎
cheilitis granulomatosa	肉芽腫性口唇炎
cheilognathopalatoschisis	唇顎口蓋裂
cheilognathoschisis	唇顎裂∥唇顎披裂
cheiloschisis	口唇裂
cheilosis	口唇症
cheiromegaly	巨指(症)
cheirospasm	書痙
chemical esophagitis	化学性食道炎
chemical hepatitis	化学性肝炎
chemical periodontitis	化学的歯周炎
chemical peritonitis	化学性腹膜炎
chest pain	胸痛(stethalgia)
chickenpox	水痘(varicella)
childhood asthma	小児性喘息
childhood cervical lymphadenopathy	小児性頚部リンパ節症
chlorephidrosis	緑汗症
chlorhydria	胃酸過多症∥過酸症
cholangiectasis	胆管拡張症
cholangiocarcinoma	胆管癌∥胆管細胞癌(bile duct carcinoma)
cholangiohepatitis	肝胆管炎
cholangiohepatoma	胆管肝癌∥肝胆管細胞癌
cholangioma	胆管腫
cholangiopathy	胆管症∥胆管病
cholangiosarcoma	胆管肉腫
cholangitis	胆管炎
cholecystalgia	胆嚢痛∥胆嚢疝痛
cholecystatony	胆嚢弛緩
cholecystectasia	胆嚢拡張症
cholecystitis	胆嚢炎
cholecystocholedocholithiasis	胆嚢総胆管結石症
cholecystolithiasis	胆嚢結石症
cholelith	胆石(chololith; gallstone)
cholelithiasis	胆石症(gallstone disease)
cholemesis	胆汁嘔吐(症)
cholemia	胆血症
choleperitoneum	胆汁性腹膜炎
cholera	コレラ
cholera diarrhea	コレラ性下痢(choleraic diarrhea)
choleraic diarrhea	コレラ性下痢(cholera diarrhea)
cholesterol embolism	コレステロール塞栓症(atheroma embolism)
chololith	胆石(cholelith; gallstone)
cholorrhea	胆汁過剰分泌(cholorrhoea)
cholorrhoea	胆汁過剰分泌(cholorrhea)
cholestasis	胆汁鬱滞
cholesteatoma	コレステリン腫
cholesterolemia	高コレステロール血症
choluria	胆汁尿
chondritis	軟骨炎
chondrodermatitis	軟骨皮膚炎
chondrodermatitis nodularis helicis	耳輪結節性軟骨皮膚炎
chondrodystrophia fetalis	胎児性軟骨異栄養症
chondrodystrophy	軟骨ジストロフィー
chondroma	軟骨腫
chondromalacia patellae	膝蓋軟骨軟化(症)
chondromyxofibroma	軟骨粘液性線維腫(chondromyxoid fibroma)
chondromyxoid fibroma	軟骨粘液性線維腫(chondromyxofibroma)
chondromyxoid sarcoma	軟骨粘液肉腫(chondromyxosarcoma)
chondromyxoma	軟骨粘液腫
chondromyxosarcoma	軟骨粘液肉腫(chondromyxoid sarcoma)
chondronecrosis	軟骨壊死
chondrosarcoma	軟骨肉腫
chondrosis	軟骨症
chonechondrosternon	漏斗胸(funnel chest; koilosternia; pectus excavatum[L])
chorea	舞踏病
chorioadenoma	絨毛腺腫
chorioadenoma destruens	破壊性絨毛腺腫[L](=invasive mole)
chorioamnionitis	絨毛羊膜炎
choriocarcinoma	絨毛癌
chorioepithelialoma	絨毛上皮腫
choristoblastoma	分離芽腫
choristoma	分離腫
choroiditis	脈絡膜炎
christmas disease	クリスマス病
chromate intoxication	クロム中毒
chronic active hepatitis	慢性活動性肝炎
chronic appendicitis	慢性虫垂炎
chronic articular rheumatism	慢性関節リウマチ
chronic caries	慢性齲蝕
chronic cervical lymphadenitis	慢性頚部リンパ節炎
chronic cervicofacial lymphadenitis	慢性頚部顔面リンパ節炎
chronic diarrhea	慢性下痢
chronic diffuse sclerosing osteomyelitis	慢性瀰満性硬化性骨髄炎
chronic gastritis	慢性胃炎
chronic inflammation	慢性炎症
chronic interstitial cystitis	慢性間質性膀胱炎
chronic interstitial pneumonia	慢性間質性肺炎
chronic lymphocytic leukemia	慢性リンパ性白血病[略 CLL]
chronic maxillary sinusitis	慢性上顎洞炎
chronic myelogenous leukemia	慢性骨髄性白血病(chronic myeloid leukemia)
chronic myeloid leukemia	慢性骨髄性白血病(chronic myelogenous leukemia)
chronic obstructive pulmonary diease	慢性閉塞性肺疾患[略 COPD]
chronic osteomyelitis	慢性骨髄炎
chronic pain	慢性痛
chronic paranasal sinusitis	慢性副鼻腔炎
chronic sclerosing sialadenitis	慢性硬化性唾液腺炎[[歯]]
chronic sialoadenitis	慢性唾液腺炎[[歯]]
chronic subdural hematoma	慢性硬膜下血腫 
chronic subdural hygroma	慢性硬膜下水腫
chronic ulcerative pulpitis	慢性潰瘍性歯髄炎
chronic villous polyarthritis	慢性絨毛性多発性関節炎
chylemia	乳糜血症
chylothorax	乳糜胸(chylopleura; chylous hydrothorax) /糜=び/
chylopleura	乳糜胸(chylothorax; chylous hydrothorax) /糜=び/
chylous hydrothorax	乳糜胸(chylothorax; chylopleura) /糜=び/
circulatory collapse	循環虚脱
cirrhosis	肝硬変
congestive cirrhosis	うっ血性肝硬変
portal cirrhosis	門脈性肝硬変
cirrhotic kidney	硬変腎
cirrhotic liver	硬変肝
claudication	跛行
intermittent claudication	間欠性跛行∥間歇的跛行
clear cell acanthoma	明細胞性棘細胞腫
clear cell hidradenoma	明細胞汗腺腫
cleft lip	唇裂∥口唇裂
cleft of lower lip	下唇裂
cleft palate	口蓋裂(palatoschisis)
cleft of soft palate	軟口蓋裂
cleft uvula	口蓋垂裂(uvula bifida[L])
cleidocranial dysostosis	鎖骨頭蓋異骨症(dysostosis cleidocranialis[L])
clinodactylia	彎曲指(症)(clinodactylia; clinodactylism; clinodactyly)
clinodactylism	彎曲指(症)(clinodactylia; clinodactyly)
clinodactyly	彎曲指(症)(clinodactylia; clinodactylism)
clitorrahagia	陰核出血
closed fracture	閉鎖骨折
clubbed finger	バチ指∥バチ状指∥太鼓バチ指∥太鼓バチ状指
coagulopathy	血液凝固障害∥凝固障害
coarctation of aorta	大動脈縮窄
coccidiosis	コクシジウム症
cochleitis	蝸牛炎
colic	疝痛
ureteral colic	尿管疝痛
colicoplegia	疝痛麻痺
colicystitis	大腸菌性膀胱炎
colicystopyelitis	大腸菌性膀胱腎盂炎
colitis	大腸炎
ulcerative colitis	潰瘍性大腸炎
collagenitis	コラーゲン炎
collapse delirium	虚脱譫妄
collum valgum	外反股[略 PBC](=coxa valga[L])
colonalgia	結腸痛
colonitis	結腸炎
colonopathy	結腸疾患
colonorrhea	粘液性結腸炎
coloproctitis	結腸直腸炎
colovesical fistula	結腸膀胱瘻
colpalgia	膣痛
colpatresia	膣閉鎖(症)(vaginal atresia)
colpitis	膣炎
colpocele	膣ヘルニア
colpocystitis	膣膀胱炎
colpopathy	膣疾患
colporrhagia	膣出血
coma	昏睡
diabetic coma	糖尿病性昏睡
combat neurosis	戦争神経症(war neurosis)
comminuted fracture	粉砕骨折(thrypsis)
common bile duct stone	総胆管結石
compensatory hypertrophy	代償性肥大
composite odontoma	複合性歯牙腫
compound fracture	開放骨折(open fracture)
compound nevus	複合性母斑
compression atrophy	圧迫萎縮(pressure atrophy)
compression fracture	圧迫骨折
compression necrosis	圧迫壊死
conchitis	甲介炎
conduction hearing impairment	伝導聴覚障害
condyloma	コンジローマ
condyloma acuminatum	尖形コンジローマ
congenital facial defect	先天性顔面欠損(facial birth defect)
congenital hearing loss	先天性難聴
congenital heart failure	先天性心不全[略 CHF]
congenital pneumonia	先天性肺炎
congenital rubella syndrome	先天性風疹症候群[略 CRS]
congenital salivary fistula	先天性唾液瘻
congenital syphilis	先天性梅毒
congestive heart failure	うっ血性心不全[略 CHF]
coniosis	1.塵埃症; 2.塵肺(症)[2](=pneumoconiosis)
conjunctival foreign body	結膜異物
conjunctivitis	結膜炎
constipation	便秘
contact allergy	接触性アレルギー
contact dermatitis	接触性皮膚炎
contracted kidney	萎縮腎
contracture	拘縮
paralytic contracture	麻痺性拘縮
contused wound	挫創
contusion	挫傷∥打撲傷
convulsion	痙攣
convulsive disorder	痙攣性疾患
coprostasis	宿便(fecal impaction)
corneal clouding	角膜混濁
corneal disease	角膜疾患
corneal foreign body	角膜異物
corneal hypoxia	角膜酸素不足
corneal marginal ulcer	角膜辺縁潰瘍
corneal ulcer	角膜潰瘍(keratohelcosis)
corneitis	角膜炎
cortical paralysis	皮質性麻痺
costal chondritis	肋軟骨炎
costalgia	肋骨痛
coxa valga	外反股[略 CHF](=collum valgum[L])
coxa vara	内反股[略 CHF]
cramp	痙攣
intermittent cramp	間欠痙攣
cranial polyneuritis	多発脳神経炎
craniofacial dysostosis	頭蓋顔面異骨症
craniomalacia	頭蓋骨軟化(症)
craniopathy	頭蓋病
craniopharyngioma	頭蓋咽頭腫∥頭蓋咽頭管腫瘍
cranioschisis	頭蓋披裂∥頭蓋裂∥二分頭蓋
craniosclerosis	頭蓋骨硬化症
craniostenosis	狭頭(症)
craniostosis	頭蓋縫合早期骨化(症)
craniosynostosis	頭蓋骨縫合早期癒合症∥頭蓋骨癒合症∥狭頭症
cricopharyngeal spasm	輪状咽頭痙攣
cryoglobulinemia	寒冷グロブリン血症
cryptococcal meningitis	クリプトコッカス髄膜炎
cryptogenic infection	無症状感染
cryptogenic liver cirrhosis	無症状肝硬変
cryptorchidism	停留睾丸∥停留精巣(retained testis; undescended testis; retentio testis[L])
cubital tunnel syndrome	肘部管症候群
cubitus valgus	外反肘(略 CHF)
cubitus varus	内反肘(略 CHF) (bow elbow)
cushing's syndrome	クッシング症候群
cutaneous abscess	皮下膿瘍(skin abscess; subcutaneous abscess)
cyanosis	チアノーゼ
cylindroma	円柱腫
cyst of papilla palatina	口蓋乳頭嚢胞
dentigerous cyst	含歯性嚢胞
dermoid cyst	類皮嚢胞
epidermoid cyst	類表皮嚢胞
eruption cyst	萌出嚢胞
globulomaxillary cyst	球状上顎嚢胞
median mandibular cyst	正中下顎嚢胞
median palatine cyst	正中上顎嚢胞
mucous cyst	粘液嚢胞
mucous retention cyst	粘液停滞嚢胞
lymphoepithelial cyst	リンパ上皮性嚢胞
nasopalatine duct cyst	鼻口蓋管嚢胞
nasoalveolar cyst	鼻歯槽嚢胞
postoperative maxillary cyst	術後性上顎嚢胞
primordial cyst	原始性嚢胞
radicular cyst	歯根嚢胞
solitary bone cyst	孤在性骨嚢胞
static bone cyst	静止性骨嚢胞
thyroglossal duct cyst	甲状舌管嚢胞
traumatic bone cyst	外傷性骨嚢胞
cystadenocarcinoma	嚢胞腺癌
cystadenofibroma	嚢胞性線維腺腫
cystadenolymphoma	嚢腺リンパ腫
cystadenoma	嚢腺腫
papillary cystadenoma	乳頭状嚢腺腫
mucinous cystadenoma	粘液性嚢腺腫
cystalgia	膀胱痛
cystic fibroma	嚢胞性線維腫
cystic fibrosis	嚢胞性線維症∥嚢状線維症
cystic hygroma	嚢胞水腫
cystic lymphangioma	嚢胞性リンパ管腫
cystic mastitis	嚢胞性乳腺炎
cystic odontoma	嚢胞性歯牙腫
cystitis	膀胱炎
emphysematous cystitis	気腫性膀胱炎
hemorrhagic cystitis	出血性膀胱炎
cystocele	膀胱瘤
cystodynia	膀胱痛
cystolithiasis	膀胱結石症
cystoma	嚢腫
cystomatits	嚢腫炎
cystomyxoma	粘液嚢腫
cystoneuralgia	膀胱神経痛
cystoparalysis	膀胱麻痺
cystoplegia	膀胱麻痺
cystoptosis	膀胱下垂[症]
cystopyelitis	膀胱腎盂炎
cystosarcoma	嚢胞肉腫
cystosarcoma phyllodes	葉状嚢胞肉腫
cystoschisis	膀胱裂
cytomegalic inclusion disease	巨大細胞性封入体症
dacryadenalgia	涙腺痛
dacryadenitis	涙腺炎
dacryocystalgia	涙嚢痛
dacryocystitis	涙嚢炎
dacryocystocele	涙嚢ヘルニア
dacryopyosis	涙管化膿(症)
dactylalgia	指痛
dactyledema	指浮腫
dactylitis	指炎
dactylodynia	指痛
dactylolysis	1.合指分離術; 2.指趾欠損(症)
dactylomegaly	巨指症
dactylosymphysis	合指症∥指癒合症
deafness	聾
decreased systemic vascular resistance	全身性血管抵抗減少
deforming spondylitis	変形性脊椎炎(spondylitis deformans[L])
degeneration	変性
calcareous degeneration	石灰変性
fatty degeneration	脂肪変性
fibrinoid degeneration	線維素様変性∥フィブリン様変性
granulovacuolar degeneration	顆粒空胞変性
mucous degeneration	粘液変性
vacuolar degeneration	空胞変性
degenerative disc disease	変性円板疾患[略 DDD]
deglutition pneumonia	嚥下性肺炎
dehydration	脱水症
dementia	痴呆
dementia paralytica	麻痺性痴呆[L]
dementia praecox	早発性痴呆[L]
dengue hemorrhagic fever	デング出血熱[略 DHF]
dentalgia	歯痛
dentinogenesis imperfecta	象牙質形成不全症[L]
dentinoma	象牙質腫
denture fibroma	義歯性線維腫
denture stomatitis	義歯性口内炎
dermatalgia	皮膚痛(dermatodynia)
dermatitis	皮膚炎
exfoliative dermatitis	剥離性皮膚炎
herpetiform dermatitis	ヘルペス状皮膚炎∥疱疹状皮膚炎(dermatitis herpetiformis[L])
dermatitis herpetiformis	ヘルペス状皮膚炎∥疱疹状皮膚炎[L](=herpetiform dermatitis)
dermatoarthritis	皮膚関節炎
dermatocellulitis	皮膚蜂巣炎
dermatocyst	皮膚嚢腫
dermatodynia	皮膚痛(dermatalgia)
dermatofibrosarcoma	皮膚線維肉腫
dermatofibrosarcoma protuberans	隆起性皮膚線維肉腫[L](=protuberant dermatofibrosarcoma)
dermatofibrosis	皮膚線維症
dermatomyositis	皮膚筋炎
dermatosis	皮膚病∥皮膚症
intoxication dermatosis	中毒疹
dermopathy	皮膚病
desmodynia	靭帯痛
desmopathy	靭帯病
desmorrhexis	靭帯断裂
desquamative gingivitis	剥離性歯肉炎[[歯]]
desquamative inflammatory vaginitis	落屑性炎症性膣炎
desquamative interstitial pneumonia	剥離性間質性肺炎
developmental bone cavity	発育性骨空洞
dextrocardia	右心症
dextrogastria	右胃症
diabetes insipidus	尿崩症
diabetes mellitus	真性糖尿病∥糖尿病
diabetic collapse	糖尿病性虚脱
diabetic ear	糖尿病耳
diabetic gangrene	糖尿病性壊疽
diabetic gingivitis	糖尿病性歯肉炎
diabetic hypertension	糖尿病性高血圧
diabetic nephropathy	糖尿病性腎症
diabetic neuropathy	糖尿病性神経症∥糖尿病性神経障害
diabetic peripheral neuropathy	糖尿病性末梢神経障害∥糖尿病性末梢性ニューロパチー∥糖尿病性末梢性ニューロパシー
diabetic polyneuritis	糖尿病性多発性神経炎
diabetic retinopathy	糖尿病性網膜症
diabetic stomatitis	糖尿病性口内炎
diaphysitis	骨幹炎
diarrhea	下痢
toxic diarrhea	中毒性下痢
tropical diarrhea	熱帯性下痢
tuberculous diarrhea	結核性下痢
diastematocrania	頭蓋正中離開
diataxia	両側運動失調(症)
diataxia cerebralis infantilis	小児脳性両側運動失調(症)[L]
dicliditis	心弁炎
diencephalosis	間脳症
diffuse glomerulonephritis	瀰漫性糸球体腎炎
dimelia	重複肢症∥複肢症
diplocoria	複瞳孔[症]∥重複瞳孔[症]∥二重瞳孔(症)
diplomellituria	二重糖尿(症)
diphtheria	ジフテリア
diphtheritic croup	ジフテリア性喉頭炎
diphtheritic myocarditis	ジフテリア性心筋炎
diphtheritic neuritis	ジフテリア神経炎
diphtheritic pseudomembrane	ジフテリア偽膜
diphtheritic stomatitis	ジフテリア性口内炎
diplegia	両側麻痺∥両麻痺∥対麻痺
diplomelia	重複肢症
diplopia	複視
direct fracture	直達骨折
diskitis	椎間板炎
dislocation	1.脱臼; 2.転位
shoulder dislocation	肩脱臼
dissemination	播種
peritoneal dissemination	腹膜播種
disseminated intravascular coagulation	播種性血管内凝固[略 DIC]
sensory disturbance	感覚障害
diverticular peritonitis	憩室性腹膜炎
diverticulitis	憩室炎
diverticulosis	憩室症
dizziness	眩暈=めまい(vertigo)
dolichocolon	長結腸[症]∥結腸過長(症)
dorsalgia	背痛
double cancer	重複癌
drug abuse	薬物乱用
drug dependence	薬物依存(症)
drug eruption	薬疹(drug rash)
drug-induced pneumonia 	薬物性肺炎∥薬剤性肺炎
drug nephropathy	薬剤性腎症
drug pneumonia	薬剤性肺炎
drug rash	薬疹(drug eruption)
dry pleurisy	乾性胸膜炎(pleuritis sicca[L])
dry socket	乾燥抜歯窩[[歯]]
ductal papilloma	導管乳頭腫
duodenal obstruction	十二指腸閉塞(症)
duodenal stenosis	十二指腸狭窄
duodenal ulcer	十二指腸潰瘍
duodenitis	十二指腸炎
duodenocholangitis	十二指腸総胆管炎
dust infection	塵埃感染
dysautonomia	自律神経障害∥自律神経失調
dyschezia	排便困難∥排便障害
dyscoria	瞳孔異常
dysdipsia	飲食困難
dysentery	赤痢
dysergia	作動不全
dysesthesia	感覚異常∥知覚不全
renal dysfunction	腎機能障害∥腎障害
dyskeratosis	異角化
dyslogia	談話困難(症)
dysmotility	運動障害
dysostosis	異骨症∥骨形成不全症
dysostosis cleidocranialis	鎖骨頭蓋異骨症[L](=cleidocranial dysostosis)
dyspepsia	消化不良
dysphagia	嚥下困難∥嚥下障害
dysphoria	不快∥身体違和
dyspituitarism	下垂体[機能]不全
dysplasia	異形成(症)
fibrous dysplasia	線維性[骨]異形成
dysplatic nervus syndrome	異型母斑症候群
dyspnea	呼吸困難
dysreflexia	反射異常
dysregulation	調節障害
dysrhythmia	律動異常
dyssomnia	睡眠異常
dysspermia	射精困難(症)
dysstasia	起立困難
dyssystole	収縮期障害
dysthymia	気分変調
dystithia	授乳困難[症]∥哺乳障害
dystocia	難産∥異常分娩
dysuria	排尿困難
ebola hemorrhagic fever	エボラ出血性熱
ecchymosis	斑状出血
echinococcosis	エキノコックス症
pulmonary echinococcosis	肺エキノコックス症
echopathy	反響症
eclabium	唇外反
eclipse retinitis	日食性網膜炎
ecthyma	膿瘡
ectocardia	心臓偏位
ectopic lens	偏位水晶体
ectopic pregnancy	子宮外妊娠
ectopic thyroid gland	異所性甲状腺
ectrodactylia	欠指[症]∥欠趾(症)(ectrodactylism; ectrodactyly)
ectrodactylism	欠指[症]∥欠趾(症)(ectrodactylia; ectrodactyly)
ectrodactyly	欠指[症]∥欠趾(症)(ectrodactylia; ectrodactylism)
ectrogeny	形成欠落
ectromelia	欠肢症
ectromelus	欠肢体
eczema	湿疹
eczema erythematosum	紅斑性湿疹[L]
edema	水腫∥浮腫
subglottic edema	声門下水腫
edentulism	無歯症(anodontia)
elastosis	弾性線維症
elephantiasis scroti	リンパ陰嚢[L](=lymph scrotum)
ellipsis	文字省略(症)
embolism	血栓症
pulmonary embolism	肺血栓症
embryonal rhabdomyosarcoma	胎児性横紋筋肉腫
embryonal sarcoma	胎芽性肉腫
embryonal teratoma	胎児性奇形腫
emesis	嘔吐
emphraxis	閉塞
emphysema	気腫
subcutaneous emphysema	皮下気腫
traumatic emphysema	外傷性気腫
emphysematous vaginitis	気腫性膣炎
empyema	蓄膿
empyesis	膿疱疹
empyocele	臍膿腫∥陰嚢膿腫
encephalalgia	頭痛
encephalemia	脳充血
encephalitis	脳炎
Japanese encephalitis	日本脳炎
encephalocele	脳ヘルニア
encephalolith	脳石(cerebral calculus)
encephalolithiaisis	脳結石症
encephalomeningitis	脳髄膜炎
encephalomeningocele	脳髄膜瘤
encephalomeningopathy	脳髄膜症(meningoencephalopathy)
encephalomyelitis	脳脊髄炎
encephalomyelopathy	脳脊髄症
encephalopathy	脳症∥脳障害
encephalopyosis	脳化膿[症]∥脳膿瘍
encephalorrhagia	脳出血(brain hemorrhage; cerebral hemorrhage; hematencephalon)
enchondromatosis	内軟骨腫症
endarteritis	動脈内膜炎
endobronchitis	気管支上皮炎
endocardial fibroelastosis	心内膜線維弾性症[略 EFE/略 ECFE/略 EF]
endocardial fibrosis	心内膜線維症
endocarditis	心内膜炎
subacute bacterial endocarditis	亜急性細菌性心内膜炎[略 SBE]
endocolitis	結腸粘膜炎
endogenic infection	内因性感染
endogenic toxicosis	内因性中毒症
endometriosis	子宮内膜症∥エンドメトリオーシス
endometritis	子宮内膜炎
endoperitonitis	腹腔漿膜炎
endorhinitis	鼻腔粘膜炎
endosalpingitis	卵管内膜炎
endosalpingoma	卵管腺筋腫
endosalpingosis	卵管内膜症
endosteoma	骨内膜腫
endothelial myeloma	内皮性骨髄腫
endotheliocytosis	内皮細胞増加症∥内皮細胞増加∥内皮細胞症
endothelioma	内皮腫
endotheliomatosis	内皮腫症
endotheliomyoma	内皮筋腫
endotheliosis	内皮症
enteritis	腸炎
enterobiasis	蟯虫症
enterocele	脱腸∥腸ヘルニア
enterocleisis	腸管閉塞
enterocolitis	小腸結腸炎
enterogastritis	胃腸炎
enteroparalysis	腸麻痺(enteroplegia)
enteropathy	腸症
enteroplegia	腸麻痺(enteroparalysis)
enteroptosis	腸下垂(症)
enterorrhagia	腸出血
enterosepsis	腸性敗血病
enterotoxemia	腸毒血症
enterotoxism	腸性中毒(症)
eosinophilia	好酸球増加症∥好酸球症(acidophilia)
eosinophilic fasciitis	好酸球性筋膜炎
eosinophilic gastritis	好酸球性胃炎
eosinophilic granuloma	好酸球性肉芽腫
eosinophilic otitis media	好酸球性中耳炎
eosinophilic pneumonia	好酸球性肺炎
eosinophilic leukemia	好酸球性白血病 
eosinophiluria	好酸球尿症
ependymitis	上衣炎
ependymoblastoma	上衣芽細胞腫
ependymoma	上衣細胞腫
ependymopathy	上衣疾患
epicondylalgia	上顆痛
epidemic cerebrospinal meningitis	流行性脳脊髄膜炎∥流行性髄膜炎
epidemic encephalitis	流行性脳炎
epidemic parotitis	流行性耳下腺炎
epidemic pleurodynia	流行性胸膜痛
epidemic stomatitis	流行性口内炎
epidemic typhus	発疹チフス
epidermitis	表皮炎
epidermolysis	表皮剥離
epidermolysis acuta toxica	急性中毒性表皮剥離[略 EAT]
epidermolysis bullosa	表皮水疱症[略 EB]
epididymitis	精巣上体炎∥副睾丸炎
epidural hematoma	硬膜外血腫
epifolliculitis	毛嚢周囲炎
epiglottitis	喉頭蓋炎
epilepsy	癲癇
postapoplectic epilepsy	脳卒中後癲癇
epimenorrhagia	月経過多
epimenorrhea	頻発月経
epiphyseal fracture	骨端骨折
epiphysitis	骨端炎
epithelioid leiomyoma	類上皮平滑筋腫
epithelialoma	上皮腫
epityphlitis	虫垂炎(appendicitis)
epulis granidarum	妊娠エプーリス(pregnancy epulis)
erosive gastritis	糜爛性胃炎
erythema	紅斑
erythema palmare	手掌紅斑(palmar erythema//red palm)
erythema marginatum	輪郭性紅斑
erythema migrans	遊走性紅斑
erythema multiforme	多形性紅斑
erythema multiforme exudativum	多形滲出性紅斑
erythema nodosum	結節性紅斑(nodal fever)
erythema solare	日照性紅斑
erythermalgia	肢端紅痛症
erythremia	赤血病
erythroblastosis	赤芽球症
erythroblastosis fetalis	胎児性赤芽球症∥胎児性赤芽細胞症[L][略 EBF](=hemolytic disease of the newborn)
erythrocytopenia	赤血球減少(症)(erythropenia)
erythrocytosis	赤血球増加(症)
erythroderma	紅皮症
erythroderma psoriaticum	乾癬性紅皮症[L](=psoriatic erythroderma)
erythrodontia	赤色歯∥紅変歯[[歯]]
erythrodysesthesia syndrome	赤色異感覚症候群
erythrokeratodermia	紅斑角皮症
erythroleukemia	赤白血病
erythropenia	赤血球減少症∥赤血球減少(erythrocytopenia)
erythroplakia	紅板症
erythroplasia	紅色肥厚症
erythropoietic abnormality	赤血球産生異常
erythruria	赤血球尿症∥血尿
esogastritis	胃粘膜炎
esophagalgia	食道痛
esophageal foreign body	食道異物
esophageal injury	食道損傷
esophagectasis	食道拡張
esophagitis	食道炎
esophagocele	食道瘤∥食道ヘルニア
esophagodynia	食道痛
esophagostenosis	食道狭窄(症)
essential hypertension	本態性高血圧
essential thrombocythemia	本態性血小板血症(略 ET)
exogenous toxicosis	外因性中毒(症)
exophthalmia	眼球突出(症)(proptosis)
exophoria	外斜位
exostosis	外骨症
exotropia	外斜視
extension fracture	伸展骨折
external inguinal hernia	外鼠蹊ヘルニア
external ophthalmoplegia	外眼筋麻痺
extrasystole	期外収縮
extrasystolic arrhythmia	期外収縮性不整脈
extrahepatic biliary obstruction	肝外胆管閉塞
exogenous eczema	外因性湿疹
exogenous mycosis	外因性真菌症
extruded disc	椎間板脱出
exudative retinopathy	滲出性網膜症
ewing's sarcoma	ユーイング肉腫
facial birth defect	先天性顔面欠損(congenital facial defect)
facial cleft	顔裂
facial granuloma	顔面肉芽腫
facial paralysis	顔面麻痺
familial hypertriglyceridemia	家族性高トリグリセリド血(症)
fasciitis	筋膜炎
fasting hypoglycemia	空腹低血糖(症)
fat hernia	脂肪ヘルニア
fatigue fracture	疲労骨折
fatty cirrhosis	脂肪性肝硬変
fatty diarrhea	脂肪性下痢(steatorrhea)
fatty infiltration	脂肪浸潤
fatty liver	脂肪肝
febrile convulsion	熱性痙攣
fecal impaction	宿便(coprostasis)
fecal incontinence	大便失禁
fecal occult blood	便潜血
femoral hernia	大腿ヘルニア
fetal alcohol syndrome	胎児性アルコール症候群[略 FAS]
fetal chondrodystrophy	胎児性軟骨ジストロフィー
fever	発熱
intermittent fever	間欠熱
rheumatic fever	リウマチ熱
fibrillation	細動
fibrinoid necrosis	類線維素壊死
fibrinous pleuritis	線維素性胸膜炎
fibroadenoma	線維腺腫
fibrodentinoma	線維象牙質腫
fibrolipoma	線維脂肪腫
fibroma	線維腫
giant cell fibroma	巨細胞性線維腫
irritation fibroma	刺激性線維腫
ossifying fibroma	化骨性線維腫
fibromatosis	線維腫症
palmar fibromatosis	手掌線維腫症
fibrometaplasia	線維性化生
fibromyalgia	線維筋痛
fibromyoma	線維筋腫
fibromyxochondroma	線維粘液軟骨腫
fibromyxoma	線維粘液腫
fibroneuroma	線維神経腫
fibro-osteoma	線維骨腫
fibropapilloma	線維乳頭腫
fibroplastic sarcoma	線維形成肉腫
fibrosarcoma	線維肉腫
fibrosis	1.線維症; 2.線維化∥線維形成
fibrotic lung disease	線維性肺疾患
fibrous osteodystrophy	線維性骨異栄養症
general fibrous osteodystrophy	汎発性線維性骨異栄養症
fibroxanthoma	線維黄色腫
filariasis	フィラリア症∥住血糸状虫症
fimbriocele	卵管采ヘルニア
fish-hook stomach	鈎状胃
fissured tongue	亀裂舌∥溝状舌(lingua dissecta[L])
flatulence	膨満∥鼓腸
flecked retina	斑点網膜
flutter	粗動
ocular flutter	眼球粗動
flying fatigue	飛行疲労
focal pneumonia	巣状肺炎
follicular adenoma	濾胞状腺腫
follicular tonsillitis	濾胞性扁桃炎
folliculitis	毛包炎∥毛嚢炎
food allergy	食物アレルギー
foraminal hernia	大孔ヘルニア
foraminal stenosis	椎孔狭窄(症)
foreign body	異物
foreign body granuloma	異物肉芽腫
foreign body reaction	異物反応
fracture	骨折
acetabular fracture	寛骨臼骨折
oblique fracture	斜骨折
open fracture	開放骨折
shearing fracture	剪端骨折
spiral fracture	螺旋骨折
subcapital fracture	骨頭下骨折
subtrochanteric fracture	転子下骨折
transverse fracture	横骨折
traumatic fracture	外傷性骨折
vertical fracture	縦骨折
fracture of talus	距骨骨折
Frey syndrome	フレイ症候群
frontal sinusitis	前頭洞炎
frothy blood	泡沫性血液
frothy urine	泡沫性尿
frozen gait	凍結歩行
fulminant hepatic failure	劇症性肝不全(略 *FHF)
fulminant hepatitis	劇症性肝炎
functional bowel disorder	機能性腸障害
fundus hypertonicus	高血圧眼底[L]
fungal conjunctivitis	真菌性角膜炎
fungal esophagitis	真菌性食道炎
fungal infection	真菌性感染(mycotic infection; mycosis)
fungal pneumonia	真菌性肺炎
funiculitis	1.髄索炎；2.精索炎
funnel chest	漏斗胸(koilosternia; chonechondrosternon; pectus excavatum[L])
gait	歩行
paralytic gait	麻痺性歩行
steppage gait	ニワトリ歩行∥鶏歩
galactidrosis	乳汗症
galactocele	乳瘤
galacturia	乳様尿
gallstone	胆石(cholelith; chololith)
gallstone disease	胆石症(cholelithiasis)
gangliocytoma	神経節細胞腫
ganglion	ガングリオン∥節腫
ganglioneuroblastoma	神経節芽細胞腫
ganglioneuroma	神経節性神経腫
ganglionitis	神経節炎
gangrene	壊疽
dry gangrene	乾性壊疽
gas gangrene	ガス壊疽
moist gangrene	湿性壊疽(wet gangrene)
wet gangrene	湿性壊疽(moist gangrene)
gangrenous stomatitis	壊疽性口内炎
gasping respiration	喘ぎ呼吸
gastralgia	胃痛
gastric antral vascular ectasia	胃前庭部毛細血管拡張症
gastric hypersecretion	胃酸分泌過多∥過酸症
gastric ulcer	胃潰瘍
gastrinoma	ガストリン産生腫瘍∥ガストリノーマ
gastritis	胃炎
gastrocele	胃ヘルニア
gastroduodenitis	胃十二指腸炎
gastrodynia	胃痛
gastroenteritis	胃腸炎
gastroenteropathy	胃腸病
gastroesophageal hernia	胃食道ヘルニア
gastroesophagitis	胃食道炎
gastrogenic diarrhea	胃性下痢
gastrohepatitis	胃肝炎
gastroileitis	胃回腸炎
gastrojejunitis	胃空腸炎
gastrolith	胃石
gastromycosis	胃真菌症 
gastromyxorrhea	胃粘液漏
gastroptosis	胃下垂
gastrorrhagia	胃出血
gastrorrhea	胃酸分泌過多
gastrospasm	胃痙攣
gastrostaxis	胃出血
general paresis	全身性不全麻痺
generalized convulsive seizure	全身性痙攣発作
generalized seizure	全身性発作
geographic choroidopathy	地図状脈絡膜症
geographic keratitis	地図状角膜炎
geographic stippling of nails	爪甲地図状斑点
geographic tongue	地図状舌
germinoma	胚細胞腫
giant cell	巨細胞
giant cell myocarditis	巨細胞心筋炎
giant cell tumor	骨巨細胞腫∥巨細胞腫(giant cell tumor of bone)
giant cell tumor of bone	骨巨細胞腫(giant cell tumor)
gigantism	巨人症
gigantomastia	巨乳症
gingivitis	歯肉炎
gingivosis	歯肉症
gingivostomatitis	歯肉口内炎[[歯]]
girdle pain	帯状痛
glandular cheilitis	腺性口唇炎
glaucoma	緑内障
glaucoma fulminans	劇症性緑内障
glioblastoma	神経膠芽細胞腫∥膠芽細胞腫∥グリア芽細胞腫(spongioblastoma)
gliocytoma	神経膠腫∥グリア細胞腫
glioma	膠腫∥神経膠腫∥グリオーム
gliomatosis	神経膠腫症
gliosis	神経膠症∥グリオーシス
gliosis uteri	子宮グリオーシス
glomerular nephritis	糸球体腎炎(glomerulonephritis)
glomerular sclerosis	糸球体腎硬化症(glomerulosclerosis)
glomerulitis	糸球体炎
glomerulonephritis	糸球体腎炎
lobular glomerulonephritis	分葉性糸球体腎炎
membranoproliferative glomerulonephritis	膜性増殖性糸球体腎炎
membranous glomerulonephritis	膜性糸球体腎炎
necrotizing glomerulonephritis	壊死性糸球体腎炎
glomerulopathy	糸球体症
glomerulosclerosis	糸球体硬化症
glossitis	舌炎
papular glossitis	丘疹性舌炎
glossitis catarrhalis	カタル性舌炎
glossitis migrans	移動性舌炎
glossodynia	舌痛
glossopharyngeal neuralgia	舌咽神経痛
glossoptosis	舌下垂
glucagonoma	グルカゴノーマ∥グルカゴン産生腫瘍
glycemia	血糖症
glycogen storage disease	糖原病∥糖原蓄積病∥糖原貯蔵症∥グリコーゲン貯蔵症(略 GSD)
glycopenia	糖欠乏症
glycosuria	糖尿症
gnathopalatoschisis	顎口蓋裂
gnathostomiasis	顎口虫症
goiter	甲状腺腫(struma)
gonadal dysgenesis	性腺形成異常(症)
gonadoblastoma	性腺芽細胞腫∥性腺芽腫 
gonarthritis	膝関節炎(gonitis)
gonarthrosis	膝関節症∥変形性膝関節症
gonitis	膝関節炎(gonarthritis)
gonorrheal arthralgia	淋菌性関節痛
gonorrheal arthritis	淋菌性関節炎
gonorrheal rheumatism	淋菌性リウマチ
gonorrheal stomatitis	淋菌性口内炎[[歯]]
gonorrheal urethritis	淋菌性尿道炎
gout	痛風(gouty a.)
gouty diabetes	痛風性糖尿病
gouty eczema	痛風性湿疹
grand mal	大発作[略 GM]
granulocytopenia	顆粒球減少(症)
granulocytosis	顆粒球増加(症)
granuloma	肉芽腫
laryngeal granuloma	喉頭肉芽腫
pyogenic granuloma	化膿性肉芽腫
granuloma annulare	環状肉芽腫[L]
granuloma faciale	顔面肉芽腫[L]
granuloma gravidarum	妊娠性肉芽腫[L]
granulomatosis	肉芽腫症
gynecomastia	女性化乳房
gynopathy	婦人病
hairy leukoplakia	毛様白板症
halitosis	口臭(bad breath)
hallux dolorosus	有痛母趾[L]
hallux flexus	底屈母趾[L]
hallux malleus	槌状母趾[L] /槌=つち/
hallux rigidus	強直母趾[L]
hallux valgus	外反母趾[L]
hallux varus	内反母趾[L]
hamartoma	過誤腫
hapalonychia	爪甲軟化(症)
haplodont	単錘歯
headache	頭痛
hearing impairment	聴覚障害
hearing loss	聴力喪失∥難聴
heart failure	心不全
heat collapse	熱虚脱
helcosis	潰瘍形成
helminthemesis	寄生虫吐出
helminthiasis	蠕虫性疾患(helminthism)
helminthoma	蠕虫腫
hemochromatosis	血色素症
hemangioblastoma	血管芽細胞腫
hemangioendothelioblastoma	血管内皮芽細胞腫
hemangioendothelioma	血管内皮腫
hemangiofibroma	血管線維腫
hemangioma	血管腫∥毛細血管腫
racemose hemangioma	蔓状血管腫
hemangiomatosis	血管腫症
hemangiopericytoma	血管外皮細胞腫
hemangiosarcoma	血管肉腫
hemarthrosis	関節出血∥出血性関節症
hematemesis	吐血
hematencephalon	脳出血(brain hemorrhage; cerebral hemorrhage; encephalorrhagia)
hematobulbia	延髄出血
hematocele	血瘤∥血腫
hematogenous abscess	血行性膿瘍
hematohidrosis	血汗症
hematoma	血腫
subdural hematoma	硬膜下血腫
hematomycosis	真菌血症
hematomyelia	脊髄出血
hematoporphyria	ポルフィリン症(porphyria)
hematosalpinx	卵管血腫
hematuria	血尿
hemianopsia	半盲
hemiatrophy	半側萎縮(症)
hemibladder	半膀胱
hemicardia	半心臓
hemicerebrum	半大脳
hemicraniosis	半頭肥大(症)
hemiglossitis	片側舌炎
hemiglossoplegia	片側舌麻痺∥舌片麻痺
hemignathia	半顎症
hemimacroglossia	片側巨舌症
hemimelia	半肢症
hemiparesis	片側不全麻痺∥半側不全麻痺
hemiplegia	半側麻痺∥片側麻痺∥片麻痺∥半身不随
hemirachischisis	半側脊椎披裂
hemodiapedesis	血液漏出
hemolysis	溶血
hemopathy	血液疾患
hemoperitoneum	腹腔内出血
hemophilia	血友病
hemophthalmia	眼球出血
hemophthalmia interna	眼内出血[L]
hemoptysis	喀血
hemorrhage	出血(bleeding)
pontine hemorrhage	橋出血(pontine bleeding)
pulmonary hemorrhage	肺出血
spinal hemorrhage	脊髄出血(hematomyelia; myelapoplexy; myelorrhagia; spinal apoplexy)
subarachnoid hemorrhage	クモ膜下出血[略 SAH](=subarachnoid bleeding)
subchoroidal hemorrhage	脈絡膜下出血
subdural hemorrhage	硬膜下出血(subdural bleeding)
subhyaloid hemorrhage	硝子体下出血
vitreous hemorrhage	硝子体出血
hemorrhagic bone cyst	出血性骨嚢胞
hemorrhagic cerebral infarction	出血性脳梗塞
hemorrhagic colitis	出血性大腸炎∥出血性結腸炎
hemorrhagic conjunctivitis	出血性結膜炎
hemorrhagic encephalitis	出血性脳炎
hemorrhagic encephalopathy	出血性脳症
hemorrhagic fever	出血熱[略 HF]
hemorrhagic infarct	出血性梗塞
hemorrhagic nephritis	出血性腎炎
hemorrhagic shock	出血性ショック
hemorrhagic thrombocythemia	出血性血小板血症
hemorrhagic ulcer	出血性潰瘍
hemorrhagic vaccinia	出血痘
hemorrhoid	痔
hemosalpinx	卵管血腫
hemosiderin	血鉄素
hemosiderosis	血鉄症
hemothorax	血胸(症)
hepatalgia	肝臓痛(hepatodynia)
hepatic angiosarcoma	肝性血管肉腫
hepatic cirrhosis	肝硬変(cirrhosis//liver cirrhosis//hepatocirrhosis)
hepatic edema	肝性浮腫
hepatic encephalopathy	肝性脳症
hepatic fibrosis	肝線維症
hepatic glomerulosclerosis	肝性糸球体硬化(症)
hepatic icterus	肝性黄疸(hepatic jaundice)
hepatic IgA nephropathy	肝性IgA腎症
hepatic jaundice	肝性黄疸(hepatic icterus)
hepatic metastasis	肝転移(liver metastasis)
hepatic myelopathy	肝性脊髄症
hepatic palmar erythema	肝性手掌紅斑(liver palmar erythema)
hepatic porphyria	肝性ポルフィリン症
hepatic rupture	肝破裂、肝臓破裂(liver rupture//rupture of liver)
hepatic steatosis	肝脂肪症、脂肪肝(liver steatosis//fatty liver)
hepatic tumor	肝腫瘍(liver tumor)
hepatitis	肝炎
chronic hepatitis	慢性肝炎
primary chronic hepatitis	原発性慢性肝炎[略 PCH]
transfusion hepatitis	輸血肝炎
hepatoblastoma	肝芽細胞腫∥肝芽腫
hepatocarcinoma	肝癌(hepatocellular carcinoma)
hepatocellular carcinoma	肝細胞癌(hepatocarcinoma)
hepatocellular jaundice	肝細胞性黄疸
hepatocholangiocarcinoma	胆管肝癌
hepatocholangitis	肝胆管炎
hepatocirrhosis	肝硬変症
hepatodynia	肝臓痛(hepatalgia)
hepatojugular reflux	肝頚静脈逆流
hepatolithiasis	肝内結石症
hepatomegaly	肝肥大∥肝腫大
hepatorenal syndrome	肝腎症候群
hepatorrhagia	肝出血
hepatorrhea	胆汁漏∥胆汁産生過多
hepatorrhexis	肝破裂∥肝臓破裂(liver rupture)
hepatosis	肝臓症
hepatosplenomegaly	肝脾腫大
hepatotoxemia	肝性毒血症
hermaphroditism	半陰陽
hernia	ヘルニア
hiatal hernia	裂孔ヘルニア
vesical hernia	膀胱ヘルニア
herniated disc	椎間板ヘルニア
herpes simplex	単純疱疹[L]
herpes simplex encephalitis	単純ヘルペス脳炎[L]
herpes zoster	帯状疱疹∥帯状ヘルペス[L]
herpes zoster ophthalmicus	眼神経帯状疱疹∥眼神経帯状ヘルペス[L]
herpes zoster oticus	耳神経帯状疱疹∥耳性帯状疱疹[L]
heteresthesia	異種感覚
heterointoxication	異種中毒(症)
hibernoma	冬眠腺腫
hiccup	しゃっくり
hidradenitis	汗腺炎
hidradenitis suppurativa	化膿性汗腺炎
hidrocystadenoma	汗腺嚢胞腺腫
hidrocystoma	汗腺嚢腫
hidrorrhea	過剰発汗
hirsutism	多毛症
histiocytosis	組織球増殖症
malignant histiocytosis	悪性組織球症[略 MH]
homocystinemia	ホモシスチン血(症)
homocystinuria	ホモシスチン尿(症)
hunger pain	飢餓痛
Hunter's glossitis	ハンター舌炎(atrophic glossitis)
hyaline degeneration	硝子様変性
hyaline membrane disease	硝子膜症[略 HMD]
hyalitis	硝子体炎
hydramnios	羊水過多(症)
hydrocalycosis	腎杯水腫
hydrocele	水瘤
hydrocephalus	水頭症
normal pressure hydrocephalus	正常圧水頭症[略 NPH]
hydromyoma	水筋腫
hydrophobia	狂水病
hydronephrosis	水腎症
hydropelvis	水腎盂症
hydrosalpinx	卵管水腫∥卵管留水症
hygroma	滑液嚢水腫∥ヒグローマ
hygroma axillare	腋窩ヒグローマ[L]
hymenitis	処女膜炎
hypacusis	聴力低下(hypoacusis)
hyperactivity	多動性
hyperalgesia	痛覚過敏(症)
hyperammonemia	過アンモニア血(症)
hyperanakinesia	多動症
hypercalcinuria	高カルシウム尿症
hypercapnia	高炭酸症
hypercellularity	細胞過多∥細胞過形成
hypercementosis	セメント質増殖症
hyperchlorhydria	胃の過酸症
hypercholia	胆汁過多(症)
hyperchondroplasia	軟骨過形成
hyperchromatism	過色素性∥過染色性
hypercorticosteroidism	副腎皮質機能亢進(症)
hyperemia	充血
hyperesthesia	感覚過敏
olfactory hyperesthesia	嗅覚過敏
hyperfunction	機能亢進(症)
hypergastrinemia	高ガストリン血(症)
hyperglycemia	高血糖症∥過血糖症
hyperglycorrhachia	髄液糖過剰(症)
hypergranulosis	顆粒層肥厚
hyperhidrosis	多汗(症)(polyhidrosis)
hyperhydration	過量輸液
hyperinsulinemia	高インスリン血[症]∥インスリン過剰血(症)
hyperkeratosis	過角化
hyperkinesia	多動
hyperlalia	多言(症)
hyperlipidemia	高脂質血(症)
hypermania	重症躁病
hypermobility	運動機能亢進
hypermyotonia	筋緊張亢進
hypermyotrophy	筋肥大
hypernatremia	高ナトリウム血[症]∥ナトリウム過剰血(症)
hyperopia	遠視
hyperorexia	食欲過剰
hyperovulation	排卵過剰
hyperoxia	高酸素[症]∥酸素過剰(症)
hyperparathyroidism	副甲状腺機能亢進(症)
hyperperfusion syndrome	過潅流症候群
hyperperistalsis	蠕動亢進
hyperphonia	発声過度
hyperplasia	過形成
hyperpnea	過呼吸
hyperproteinemia	高蛋白血症
hyperpyrexia	超高熱
hyperreflexia	反射亢進
hypersensibility	感覚過敏
hypersplenism	脾機能亢進(症)
hypertension	高血圧(症)
ocular hypertension	高眼圧(症)
portal hypertension	門脈高血圧
hypertensive episode	高血圧発作
hypertensive encephalopathy	高血圧性脳症
hypertensive heart disease	高血圧性心疾患(略 HHD)
hypertensive retinopathy	高血圧性網膜症
hypertelorism	隔離症
hyperthermia	高体温[症]∥過温症∥高熱
hyperthyroidism	甲状腺機能亢進症
hypertonic bladder	高張膀胱
hypertriglyceridemia	高トリグリセリド血(症)
hypertrophic cardiomyopathy	肥大型心筋症[略 HCM]
hypertrophy	肥大
ventricular hypertrophy	心室性肥大
hyperuricemia	高尿酸血(症)
hyperuricuria	高尿酸尿(症)
hypervascularity	血管分布過多
hyperventilation	過換気
hypesthesia	感覚減退∥感覚鈍麻(hypoesthesia)
olfactory hypesthesia	嗅覚鈍麻
hypoacusis	聴力低下(hypacusis)
hypoalphalipoproteinemia	低α蛋白血(症)
hypoalimentation	低栄養
hypobarism	低圧(症)
hypocalcemia	低カルシウム血(症)
hypocapnia	低炭酸症
hypochloraemia	低塩素血[症]∥低クロール血(症)(hypochloremia)
hypochloremia	低塩素血[症]∥低クロール血(症)(hypochloraemia)
hypochondrogenesis	軟骨低形成(症)
hypochondroplasia	軟骨低形成(症)
hypochylia	乳糜減少(症)
hypocorticosteroidism	副腎皮質機能低下(症)
hypocytosis	血球減少(症)
hypodontia	部分性無歯[症]∥歯数不足(症)
hypoesthesia	感覚減退∥感覚鈍麻(hypesthesia)
hypofunction	機能低下(症)
hypogenesis	形成不全[症]∥発育不全(症)
hypoglycemia	低血糖(症)
hypoglycorrhachia	髄液糖減少(症)
hypohidrosis	発汗減少
hypohydration	脱水症
hypoinsulinemia	低インスリン血(症)
hypoinsulinism	低インスリン症
hypokalemia	低カリウム血(症)
hypolipemia	低脂肪血(症)
hypoliposis	低脂肪[症]∥脂肪減少(症)
hypomania	軽躁[病]
hypomelanotic melanoma	低メラニン色素性黒色腫
hypometabolism	低代謝∥代謝低下
hypomotility	低運動性
hypomyotonia	筋弛緩(症)
hypopancreatism	膵臓機能低下[症]∥膵臓機能減退(症)
hypophonia	発音不全
hypophoria	下斜位
hypoplasia	低形成∥減形成
hypoplastic left heart syndrome	左心低形成症候群[略 HLHS]
hypopnea	呼吸低下
hypopotassemia	低カリウム血(症)
hypoproteinemia	低蛋白血症
hyposecretion	分泌不全∥分泌減退
hypotension	低血圧[症]∥緊張低下(症)
hypothermia	低体温
hypothymia	気分沈滞
hypothyroidism	甲状腺機能低下(症)
hypotonia	低圧
hypotrichosis	先天性貧毛(症)
hypotrichosis congenita	先天性貧毛(症)[L]
hypoventilation	低換気∥呼吸低下(underventilation)
hypovitaminosis	ビタミン不足(症)
hypovolemia	低血液量[症]∥血液量減少(症)
hypovolia	減量症
hypoxemia	低酸素血(症)
hypoxia	低酸素(症)
hypoxic encephalopathy	低酸素性脳症(anoxic encephalopathy) 
hypoxic ischemic encephalopathy	低酸素性虚血性脳症 
hypsicephaly	高頭蓋症∥塔状頭蓋症
hypsicrany	高頭蓋症
hypsodont	長冠歯
hysteralgia	子宮痛
hysteritis	子宮炎
hysterodynia	子宮痛
hysterolith	子宮結石
hysteroptosis	子宮下垂
hysterorrhexis	子宮破裂(症)(metrorrhexis)
hysterospasm	子宮痙攣
ichthyosis	魚鱗癬
icterus	黄疸
idiopathic aplastic anemia	特発性再生不良性貧血
idiopathic bone cavity	特発性骨空洞∥特発性骨腔
idiopathic pulmonary fibrosis	特発性肺線維症[略 IPF]
idiopathy	特発症
ileitis	回腸炎
ileocolitis	回結腸炎
ileus	腸閉塞[症]∥イレウス
paralytic ileus	麻痺性腸閉塞(症)
immunodeficiency	免疫不全(症)
imperforate anus	鎖肛(anal atresia; aproctia; atresia ani[L])
impetigo	膿痂疹
imported infectious disease	輸入感染症
incarceration	嵌頓(症)
incipient herniation	初発ヘルニア形成
incontinence	失禁
urinary incontinence	尿失禁
incontinentia pigmenti	色素失調(症)
induration	硬化∥硬結∥硬結部
infantile fibrosarcoma	小児性線維肉腫
infantile seborrheic dermatitis	脂漏性乳児皮膚炎
infarction	梗塞
pulmonary infarction	肺梗塞
viral infection	ウイルス性感染
infectious arthritis	感染性関節炎
infectious bulbar paralysis	感染性球麻痺
infectious conjunctivitis	伝染性結膜炎
infectious mononucleosis	伝染性単核症∥伝染性単核球症∥伝染性単核細胞症(略 IM)
infectious spondylitis	感染性脊椎炎 ＝化膿性脊椎炎∥細菌性脊椎炎
influenza	インフルエンザ
influenza-associated encephalopathy	インフルエンザ脳症
infundibular pulmonary stenosis	肺動脈漏斗部狭窄
inhalation pneumonia	吸入性肺炎∥吸引性肺炎
insomnia	不眠(症)
insufficiency	不全(症)
insulinoma	インスリン腫
intercostal neuralgia	肋間神経痛
interlobular pleurisy	小葉間胸膜炎
intermittent malaria	間欠熱マラリア
intermittent pain	間欠痛
intervertebral space cyst	椎間腔嚢胞
internal granuloma	内部性肉芽腫[[歯]]〈歯髄〉
internal injury	内臓損傷
internal resorption	内部性吸収[[歯]]〈根管〉
interstitial cystitis	間質性膀胱炎
interstitial gastritis	間質性胃炎
interstitial glossitis	間質性舌炎
interstitial nephritis	間質性腎炎
interstitial pneumonia	間質性肺炎(略 IP)
intestinal polyp	腸ポリープ
intestinal tuberculosis	腸結核
intolerance	不耐性
lactose intolerance	乳糖不耐性
intoxication	中毒(poisoning)
paraquat intoxication	パラコート中毒
water intoxication	水中毒
intra-alveolar pneumonia	肺胞内肺炎
intracanalicular fibroadenoma	管内性線維腺腫
intracranial hypertension	頭蓋内圧亢進症
intradermal nevus	真皮内母斑
intraductal papillary mucinous tumor	膵管内乳頭粘液性腫瘍(略 IPMT)
intrahepatic cholangiocarcinoma	肝内胆管癌
intraligamentary pregnancy	靭帯内妊娠
intumescentia abdominis	腹部膨大
invasive carcinoma	浸潤癌
invasive ductal carcinoma	浸潤性乳管癌
invasive lobular carcinoma	浸潤性小葉癌〈乳癌〉
invasive mole	侵入奇胎(chorioadenoma destruens[L])
inverted nipple	陥没乳頭
inverted papilloma	逆性乳頭腫∥内翻性乳頭腫
inversion of nipple	乳首内反
iralgia	虹彩痛(iridalgia)
iridalgia	虹彩痛(iralgia)
iridectropium	虹彩外反(症)
iridemia	虹彩出血
iridentropium	虹彩内反(症)
irideremia	無虹彩[症]∥虹彩欠損(症)
iridoavulsion	虹彩裂離
iridocele	虹彩嚢胞
iridochoroiditis	虹彩脈絡膜炎
iridocyclitis	虹彩毛様体炎
iridokeratitis	虹彩角膜炎
iridopathy	虹彩症
iritis	虹彩炎
traumatic iritis	外傷性虹彩炎
iritis glaucomatosa	緑内障性虹彩炎[L]
irradiation fibromatosis	照射性線維腫症
jaundice	黄疸
jejunitis	空腸炎
jejunoileitis	空回腸炎
junctional nevus	結合部母斑
juvenile hemangioma	若年性血管腫
juvenile melanoma	若年性黒色腫
juvenile periodontitis	若年性歯周炎
juvenile rheumatoid arthritis	若年性リウマチ様関節炎[略 JRA]
juxtaductal coarctation of aorta	傍動脈管型大動脈縮窄
juxtaglomerular cell tumor	傍糸球体細胞腫
kalemia	カリウム血症
kaliopenia	カリウム欠乏(症)
kaposi's sarcoma	カポジ肉腫
karyolysis	核溶解
karyorrhexis	核崩壊
keratectasia	角膜拡張症
keratin pearl	癌真珠
keratitis	角膜炎
marginal keratitis	辺縁角膜炎
keratitis parenchymatosa	実質性角膜炎[略 KP]
keratoacanthoma	角化棘細胞腫
keratoconjunctivitis	角膜結膜炎
ultraviolet keratoconjunctivitis	紫外線角膜結膜炎
keratocyst	角化性嚢胞
keratoderma	角皮症(leukoplakia)
keratoglobus	球状角膜
keratohelcosis	角膜潰瘍(corneal ulcer)
keratoma	角化腫
keratoscleritis	角膜強膜炎
keratosis	角化症
koilocytosis	空胞細胞症∥コイロサイトーシス 
koilosternia	漏斗胸(funnel chest; chonechondrosternon; pectus excavatum[L])
korsakoff syndrome	コルサコフ症候群
kraurosis	萎縮症
kyphoscoliosis	脊椎後側彎症
kyphosis	脊椎後彎症∥後彎症∥亀背
labiochorea	口唇舞踏病
lactocele	乳瘤
lacunar tonsillitis	陰窩性扁桃炎
laparocele	腹部ヘルニア
laryngeal cancer	喉頭癌
laryngeal crisis	喉頭発症
laryngeal edema	喉頭浮腫
laryngeal papillomatosis	喉頭乳頭腫症
laryngeal paralysis	喉頭麻痺(laryngoplegia)
laryngeal perichondritis	喉頭軟骨膜炎
laryngeal phthisis	喉頭結核(laryngophthisis)
laryngitis	喉頭炎
subglottic laryngitis	声門下喉頭炎
laryngomalacia	喉頭軟化症
laryngoplegia	喉頭麻痺(laryngeal paralysis)
laryngospasm	喉頭痙攣∥声門痙攣
laryngostenosis	喉頭狭窄
laryngotracheitis	喉頭気管炎
late infection	遅発性感染
lateral abscess	根側膿瘍[[歯]]
lateral cyst	根側嚢胞[[歯]](lateral periodontal cyst) ＝側方性歯周嚢胞 
lateral granuloma	根側肉芽腫[[歯]]
lateral periodontal cyst	根側嚢胞[[歯]](lateral cyst) ＝側方性歯周嚢胞
lateral radicular cyst	根側性歯根嚢胞[[歯]]
left ventricular hypertrophy	左室肥大∥左心室肥大
leiomyofibroma	平滑筋線維腫
leiomyoma	平滑筋腫
leiomyoma cutis	皮膚平滑筋腫
leiomyomatosis	平滑筋腫症
leiomyosarcoma	平滑筋肉腫
lentiginosis	多発性黒子症
lentigo	黒子
lentigo maligna	悪性黒子
lentigo maligna melanoma	悪性黒子黒色腫(略 LMM)
leprosy	癩
leptocephalia	狭小頭蓋症∥狭頭症
leptocytosis	標的赤血球増加症
leptomeningitis	軟膜炎
leptoprosopia	長顔症
leptospirosis	レプトスピラ症〈Leptospira interrogansによる感染症〉
leptotrichosis conjunctivae	結膜レプトトリックス症
leukemia	白血病
plasma cell leukemia	形質細胞性白血病
promyelocytic leukemia	前骨髄球性白血病
leukemic stomatitis	白血病性口内炎
leukemic gingivitis	白血病性歯肉炎
leukocoria	白色瞳孔
leukocyte migration inhibition	白血球遊走阻止(略 LMI)
leukocytopenia	白血球減少(症)(leukopenia)
leukocytoplania	白血球遊出
leukocytosis	白血球増加(症)
leukodystrophy	白質異栄養(症)
leukoedema	白色浮腫
leukoencephalopathy	白質脳症
leukomalacia	白質軟化(症)
leukomyelitis	白質脊髄炎∥脊髄白質炎
leukonychia	爪甲白斑(症)
leukopedesis	白血球漏出
leukopenia	白血球減少(症)(leukocytopenia)
leukoplakia	白板症
verrucous leukoplakia	疣贅性白板症
leukorrhea	白帯下∥帯下/たいげ/
leukosis	白血症
leukostasis	白血球停滞
lichen	苔癬 
lichen planus	扁平苔癬(略 LMM)
lichen sclerosus	硬化性苔癬
lichen striatus	線状苔癬
lichenoid dermatosis	苔癬様皮膚症∥苔癬様皮膚病
lichenoid dysplasia	苔癬様異形成
lichenoid eczema	苔癬様湿疹 
lichenoid keratosis	苔癬様角化症
lid abscess	眼瞼膿瘍
lid retraction	眼瞼後退
linea alba buccalis	頬部白線
lingua dissecta	亀裂舌∥溝状舌[L](=fissured tongue)
lingual thyroid	舌甲状腺
lipemic retinopathy	脂肪血[症]性網膜症
lipid pneumonia	脂肪性肺炎(lipoid pneumonia)
lipoblastoma	脂肪芽細胞腫
lipodystrophia	脂肪ジストロフィ(lipodystrophy)
lipodystrophy	脂肪ジストロフィ(lipodystrophia)
lipoid pneumonia	リポイド肺炎(lipid pneumonia)
lipofibroma	脂肪線維腫
lipofibromyxoma	脂肪線維粘液腫
lipogranulomatosis	脂肪肉芽腫症
lipoma	脂肪腫
ossifying lipoma	骨化性脂肪腫
lipomatosis	脂肪腫症
lipomeningocele	脂肪髄膜瘤
liposarcoma	脂肪肉腫
lipotrophy	脂肪増多(症)
liquorrhea	髄液漏
lithonephritis	結石性腎炎
liver abscess	肝膿瘍
liver palmar erythema	肝性手掌紅斑(hepatic palmar erythema)
lobar pneumonia	大葉性肺炎
lobular atelectasis	小葉性無気肺
lobular pneumonia	小葉性肺炎
localized scleroderma	限局性強皮症
longitudinal fracture	縦骨折(vertical fracture)
lordoscoliosis	脊椎前側彎症
lordosis	脊椎前彎症
low-grade fibromyxoid sarcoma	低悪性線維粘液性肉腫
lower motor neuron lesion	下位運動ニューロン障害(略 LMNL)
ludwig angina	ルードウィッヒアンギーナ
lumbago	腰痛(症)
lumbar myelopathy	腰髄症
lung contusion	肺挫傷(pulmonary contusion)
lung damage	肺損傷(lung injury; pulmonary damage)
lung disease	肺疾患(pulmonary disease)
lung infarction	肺梗塞(pulmonary infarction)
lung injury	肺損傷(lung damage; pulmonary damage)
lung tumor	肺腫瘍
lupus erythematosus	紅斑性狼瘡
lupus hypertrophicus	肥厚性狼瘡
systemic lupus erythematosus	全身性紅斑性狼瘡∥全身性エリテマトーデス(略 SLE)
lupus nephritis	ループス腎炎
lupus tuberculosus	結核性狼瘡
lyme arthritis	ライム関節炎
lyme disease	ライム病(ライム関節炎)
lymph scrotum	リンパ陰嚢(elephantiasis scroti)
lymph varix	リンパ管怒張∥リンパ管瘤
lymphadenitis	リンパ節炎
lymphadenoma	リンパ節腫
sebaceous lymphadenoma	脂腺リンパ節腫
lymphadenopathy	リンパ節障害∥リンパ節症
lymphangioma	リンパ管腫
lymphangitis	リンパ管炎
lymphatitis	リンパ組織炎
lymphedema	リンパ水腫
lymphoblastic lymphoma	リンパ芽球性リンパ腫
lymphocytic leukemia	リンパ球性白血病
lymphocytopenia	リンパ球減少(症)
lymphoepithelioma	リンパ上皮腫
lymphogranulomatosis	リンパ肉芽腫症
lymphoma	リンパ腫
malignant lymphoma	悪性リンパ腫
lymphoplasmacytic lymphoma	リンパ球形質細胞性リンパ腫
lymphosarcoma	リンパ肉腫
lymphuria	リンパ尿症
macrocheilia	巨唇症
macrodactylia	大指症
macrodontia	巨大歯
macrogenitosomia	早発性大性器症
macroglossia	大舌症
macrognathia	大顎症
macronychia	巨爪(症)
macropyuria	肉眼的膿尿
macrosomia	巨人症(gigantism; somatomegaly)
macula solaris	夏日斑∥雀斑
macular dystrophy	黄斑ジストロフィー
occult macular dystrophy	オカルト黄斑ジストロフィー
magenta tongue	赤色舌炎
malaria	マラリア
malignant hyperthermia	悪性高熱(症)
malignant melanoma	悪性黒色腫
malignant mesothelioma	悪性中皮腫
malignant paraganglioma	悪性傍神経節腫
malnutrition	栄養失調∥栄養不良
malpresentation	胎位異常
malreduction	不全整復
mammalgia	乳房痛(mastalgia; mastodynia; mammodynia)
mammary neuralgia	乳房神経痛
mammodynia	乳房痛(mastalgia; mammalgia; mastodynia)
manifest hyperopia	顕性遠視(略 Hm)
massive collapse	大虚脱
mastalgia	乳房痛(mammalgia; mastodynia; mammodynia)
mastitis	乳腺炎
mastocytosis	肥満細胞症
mastocytoma	肥満細胞腫
mastodynia	乳房痛(mastalgia; mammalgia; mammodynia)
mastoidalgia	乳突痛∥乳様突起痛
mastoiditis	乳突炎∥乳様突起炎
maxillary bone fracture	上顎骨折
maxillary retrusion	上顎後退症
maxillitis	上顎炎
mature epithelial tumor	成熟型上皮性腫瘍
measles	麻疹
mediastinal teratoma	縦隔奇形腫
mediastinitis	縦隔炎
mediastinopericarditis	縦隔心膜炎
medullary porencephaly	髄質孔脳症
medulloencephalitis	髄質脳炎
medulloblastoma	髄芽細胞腫
medulloepithelioma	髄様上皮腫
megabladder	巨大膀胱(megacystis; megalocystis)
megacolon	巨大結腸
megacystis	巨大膀胱(megabladder; megalocystis)
megakaryocytosis	巨核球症
megaloblastic anemia	巨赤芽球性貧血
megaloblastosis	巨赤芽球症
megalocardia	巨心症
megalocystis	巨大膀胱(megabladder; megacystis)
megalodactyly	巨指症
megalomelia	巨肢症
megasigmoid	巨大S状結腸
meibomitis	マイボーム腺炎
meibomian gland dysfunction	マイボーム腺機能障害  
melagra	四肢筋痛∥肢筋痛
melalgia	肢痛
melanidrosis	黒色汗症
melanoma	黒色腫
melanomatosis	黒色腫症
melanoplakia	黒斑症
melanosis	黒色症
peritoneal melanosis	腹膜黒色症(melanosis peritonei)
melanosis iridis	虹彩黒色症
melanuria	黒色尿∥メラニン尿
melena	黒色便∥下血∥メレナ
melitis	頬炎
melomelus	副肢症∥副肢奇形∥副肢奇形体
membranous nephropathy	膜性腎症
membranous rhinitis	膜性鼻炎
menalgia	月経痛
meningeal irritation syndrome	髄膜刺激症候群
meningeal leukemia	髄膜白血病
meningeal tuberculosis	髄膜結核
meningioma	髄膜腫
meningiomatosis	髄膜腫症
meningitis	髄膜炎
Mollaret's meningitis	モラレー髄膜炎
Neisseria meningitis	髄膜菌炎[略 NM]
pneumococcal meningitis	肺炎球菌[性]髄膜炎
purulent meningitis	化膿性髄膜炎
serous meningitis	漿液性髄膜炎
spinal meningitis	脊髄[髄]膜炎(myelomeningitis; meningomyelitis)
tuberculous meningitis	結核性髄膜炎
meningocele	髄膜瘤
meningococcal meningitis	髄膜炎性髄膜炎
meningococcemia	髄膜炎菌血症
meningoencephalitis	髄膜脳炎
meningoencephalocele	髄膜脳瘤
meningoencephalomyelitis	髄膜脳脊髄炎
meningoencephalopathy	髄膜脳障害∥髄膜脳症(encephalomeningopathy)
meningomalacia	髄膜軟化症
meningomyeloencephalitis	髄膜脊髄脳炎
meningorrhagia	髄膜出血
meniscitis	半月軟骨炎
meniscocyte	鎌状赤血球
menopausal syndrome	閉経症候群
menstrual edema	月経性水腫∥月経性浮腫
menopause	閉経∥月経閉止
menophania	月経初潮
menorrhagia	月経過多
menorrhalgia	月経痛
menoschesis	月経閉止
menouria	月経尿
menoxenia	月経不順
menstrual pain	生理痛
mesenchymoma	間葉腫
mesenteritis	腸間膜炎
mesial temporal sclerosis	内側側頭葉硬化症
mesiotemporal lobe epilepsy	内側側頭葉癲癇
mesioversion	近心転位
mesonephroma	中腎腫
mesothelioma	中皮腫
peritoneal mesothelioma	腹膜中皮腫
sarcomatous mesothelioma	肉腫性中皮腫
metabolic diseases	代謝疾患
metal allergy	金属アレルギー 
metallophobia	金属恐怖(症)
metalues	変性梅毒
metaphysitis	骨幹端炎
metaplasia	化生
metastasis	転移
metastatic tumor	転移性腫瘍
metatarsalgia	中足骨痛
metralgia	子宮痛
metritis	子宮炎
metroendometritis	子宮内膜筋層炎
metromalacia	子宮軟化症
metroperitonitis	子宮腹膜炎
metrorrhea	子宮漏
metrorrhexis	子宮破裂(症)(hysterorrhexis)
micrencephalus	小脳症体∥小脳髄症体
micrencephaly	小脳症∥小脳髄症(microencephaly)
microabscess	微小膿瘍
microaneurysms	微小動脈瘤
microangiopathy	微小血管症
microcardia	小心症
microcephalus	小頭体
microcephaly	小頭蓋[症]∥小頭(症)
microcheilia	小唇症
microcheiria	小手症
microcolon	小結腸症
microcoria	小瞳孔症
microcyst	微小嚢胞∥小嚢胞
microcytosis	小球症
microdactyly	小指症
microdontia	小歯症∥矮小歯
microencephaly	小脳症∥小脳髄症(micrencephaly)
microgastria	小胃症
microgenesis	矮小発育
microgenia	小下顎(症)
microgenitalism	小性器(症)
microglioma	小膠細胞腫
microgliosis	小膠細胞症
microglossia	小舌症
micrognathia	小顎症
micrographia	小書症∥小字症
microphthalmia	小眼球(症)
micropsia	小視症
microsomia	小人症
microstomia	小口症
microtia	小耳症
middle phalanx fracture	中節骨折
migraine	偏頭痛=片頭痛
miliary atelectasis	粟粒性無気肺
miliary tuberculosis	粟粒結核
mixed astigmatism	混合乱視
monarthritis	単関節炎
monkeypox	サル痘
monoarthralgia	単関節痛
monoarthritis	単関節炎
monochorditis	一側性声帯炎
monoculus	単眼奇形
monocytosis	単球増加症∥単球増多症
monomyositis	単発性筋炎
mononucleosis	単核症∥単核球症∥単核細胞症
monoplegia	単麻痺
moon face	満月様顔貌
mottled tooth	斑状歯
movable kidney	遊走腎(floating kidney)
mucinous carcinoma	粘液癌
mucocele	粘液瘤(mucous retention cyst)
mucoclasis	粘膜破壊
mucocutaneous lymph node syndrome	皮膚粘膜リンパ節症候群[略 MLNS](=川崎病)
mucoenteritis	小腸粘膜炎
mucopolysaccharidosis	ムコ多糖症
mucopolysacchariduria	ムコ多糖尿
mucositis	粘膜炎
mucous diarrhea	粘液性下痢
mucoviscidosis	膵線維症
multicystic kidney	多嚢胞腎∥嚢胞腎(polycystic kidney)
multidrug resistant tuberculosis	多薬物耐性結核
multifocal motor neuropathy	多病巣性運動神経症
multimammae	多乳房(症)
multiple myeloma	多発性骨髄腫
multiple organ failure	多臓器不全[略 MOF]
mural pregnancy	壁妊娠
muscle fatigue	筋疲労
myalgia	筋肉痛(muscle ache)
myasthenia gravis	重症筋無力症
myasthenic syndrome	筋無力症候群
mycetoma	菌腫
mycoplasma infection	マイコプラズマ感染症
mycoplasma pneumonia	マイコプラズマ肺炎 
mycosis	真菌症
mycosis fungoides	菌状息肉症[略 MF]
mycotic infection	真菌性感染(fungal infection)
mycotic pneumonia	真菌性肺炎
mycotic stomatitis	真菌性口内炎
myelapoplexy	脊髄出血
myelatrophy	脊髄萎縮
myelitis	脊髄炎
myelocele	脊髄瘤(syringocele)
myelofibrosis	骨髄線維症
myelogenous leukemia	骨髄性白血病
myelolipoma	骨髄脂肪腫
myeloma	骨髄腫
plasma cell myeloma	形質細胞性骨髄腫
myelomeningitis	脊髄髄膜炎
myeloparalysis	脊髄麻痺(spinal paralysis; myeloplegia)
myelopathy	髄症∥ミエロパチー
vascular myelopathy	血管性ミエロパチー
myelophthisis	脊髄癆∥骨髄癆
myeloplegia	脊髄麻痺
myelorrhagia	脊髄出血
myelosis	髄症∥脊髄症
myelosyphilis	脊髄梅毒(spinal syphilis)
myoblastoma	筋芽細胞筋腫
myocardial fibrosis	心筋線維症[略 MF]
myocardial infarction	心筋梗塞
myocardiopathy	心筋障害∥心筋症
myocarditis	心筋炎
tuberculous myocarditis	結核性心筋炎
myodesopsia	飛蚊症
myoepithelioma	筋上皮腫
myofascitis	筋膜炎
myolipoma	筋脂肪腫
myoma	筋腫
myoma uteri	子宮筋腫
myoma uteri submucosum	子宮粘膜下筋腫[L]
myomalacia cordis	心筋軟化症[L]
myometritis	子宮筋層炎
myositis	筋炎
myositis ossificans	骨化性筋炎[L]
myringitis	鼓膜炎
myxasthenia	粘液分泌欠乏(症)
myxedema	粘液水腫
myxoadenoma	粘液腺腫
myxochondroma	粘液軟骨腫
myxochondrosarcoma	粘液軟骨肉腫
myxofibroma	粘液線維腫
myxofibrosarcoma	粘液線維肉腫
myxoglioma	粘液神経膠腫
myxoma	粘液腫
odontogenic myxoma	歯原性粘液腫
myxomatosis	粘液腫症
myxorrhea	粘液漏
myxosarcoma	粘液肉腫
naevus fuscocaerules ophthalmomaxillaris	眼上顎褐青色母斑[L]
nail ringworm	爪白癬(tinea unguium[L])
nanocephaly	小頭症
nasal obstruction	鼻閉塞
nasal polyp	鼻ポリープ∥鼻茸
nasopharyngitis	鼻咽頭炎
nausea	悪心
navicular abdomen	舟状腹
navicular disease	舟状関節炎
necrobiosis	類壊死[症]∥死生
necrobiosis lipoidica	リポイド類壊死症∥類脂質性類壊死症
necrobiosis lipoidica diabeticorum	糖尿病性リポイド類壊死症
necrosis	壊死
necrotized chilblain	壊死性凍瘡
necrotizing angiitis	壊死性血管炎
necrotizing fasciitis	壊死性筋膜炎
necrotizing sialometaplasia	壊死性唾液腺化生<[歯]>
necrotizing lymphadenitis	壊死性リンパ節炎
neoplasm	新生物
nephralgia	腎疼痛
nephritis	腎炎
transfusion nephritis	輸血腎炎
nephroblastoma	腎芽細胞腫
nephrolith	腎石
nephrolithiasis	腎石症
nephrolysis	腎細胞溶解
nephroma	腎腫
nephropathy	腎症∥腎障害
nephroptosis	腎下垂症
nephrosis	腎症∥ネフローゼ
nephrotoxicity	腎毒性
neural fibrolipoma	神経性線維脂肪腫
neuralgia	神経痛
neurilemmoma	神経鞘腫
neurinofibroma	神経鞘線維腫
neurinomatosis	神経鞘腫症
neuritis	神経炎
neuroblastoma	神経芽細胞腫∥神経芽腫
neurocytoma	神経細胞腫
neuroepithelioma	神経上皮腫
neurofibroma	神経線維腫
neurofibromatosis	神経線維腫症
neurofibrosarcoma	神経線維肉腫
neuroganglioma	神経節腫
neuroglioma	神経膠腫
neurolipoma	神経脂肪腫
neuroma	神経腫
traumatic neuroma	外傷性神経腫
neuromyelitis	神経脊髄炎
neuromyopathy	神経症∥神経筋障害∥ニューロミオパシー
neuronevus	神経母斑
neuroparalysis	神経性麻痺
neuropathy	神経症∥神経障害
neuroplegia	神経遮断
neuropsychosis	神経精神病
neurosis	神経症
neurotic alopecia	神経性脱毛症
neurotoxicity	神経毒性
neurotoxin	神経毒
neutropenia	好中球減少症
nevus	母斑
pigmented nevus	色素性母斑
nicotinic stomatitis	ニコチン性口内炎
nodular melanoma	結節性黒色腫(略 NM)
non-occlusive mesenteric ischemia	非閉塞性腸間膜虚血
nonspecific urethritis	非特異性尿道炎
nonspecific vaginitis	非特異性膣炎
non-ulcer dyspepsia	非潰瘍性消化不良
normal tension glaucoma	正常眼圧緑内障(略 NTG)
nosocomephrenia	入院うつ病
nosocomial sepsis	院内感染敗血症
nosomania	疾病狂∥疾病妄想症
nosophilia	好病症∥疾病希求症
nosophobia	疾病恐怖(症)
nosotoxicosis	中毒性疾患
notalgia	背痛
nyctalgia	夜間痛
nyctalope	夜盲症患者
nyctalopia	夜盲症∥鳥目(night blindness)
nyctophilia	暗夜愛好[症]∥好暗黒(症)
nyctophobia	暗闇恐怖(症)
nycturia	夜間頻尿(症)
nymphomania	女子色情症
nystagmus	眼振
refractory nystagmus	退縮眼振(nystagmus of retraction)
sagittal nystagmus	垂直眼振
obesity	肥満(症)
obliterating bronchiolitis	閉塞性細気管支炎(obstructive bronchiolitis)
obliterating pericarditis	閉塞性心膜炎
obliterating phlebitis	閉塞性静脈炎(obstructive phlebitis)
obstruction	閉塞
obturation obstruction	閉塞性腸閉塞
occlusal trauma	咬合性外傷
occult blood	潜血
occult blood in urine	尿潜血
ocular injury	眼球外傷∥眼外傷
ocular myoclonus	眼球ミオクローヌス
ocular perforating injury	穿孔性眼外傷
ocular torticollis	眼性斜頚
oculodynia	眼痛∥眼球痛(ophthalmalgia; eye pain; ocular pain)
oculopathy	眼病∥眼疾患
odontalgia	歯痛
odontodysplasia	歯牙異形成(症)
odontolith	歯石(dental calculus)
odontogenic carcinoma	歯原性癌腫
odontogenic carcinosarcoma	歯原性癌肉腫
odontogenic clear cell tumor	歯原性明細胞腫
odontogenic cyst	歯原性嚢胞
odontogenic fibroma	歯原性線維腫
odontogenic keratocyst	歯原性角化嚢胞
odontogenic maxillary sinusitis	歯性上顎洞炎
odontogenic mixed tumor	歯原性混合腫瘍
odontogenic sarcoma	歯原性肉腫
odontogenic tumor	歯原性腫瘍
odontoma	歯牙腫
complex odontoma	複雑性歯牙腫
compound odontoma	集合性歯牙腫
odontophobia	歯科治療恐怖(症)
odynacusis	騒音耳痛
odynophagia	嚥下痛
odynophobia	疼痛恐怖(症)
odynophonia	発声痛∥発声疼痛(症)
oligemia	乏血(症)
oligoamnion	羊水過少(症)
oligodendroblastoma	希突起膠芽[細胞]腫∥乏突起膠芽[細胞]腫
oligodendrocytoma	希突起膠[細胞]腫∥乏突起膠[細胞]腫 
oligodendroglioma	希突起膠[細胞]腫∥乏突起膠[細胞]腫
oligodontia	寡歯症
oligohydramnion	羊水過少(症)
oligohydrosis	発汗減少(症)
oligophrenia	精神遅滞(mental retardation//hypophrenia)
oligotrichia	貧毛(症)
oliguria	乏尿
oliguric renal failure	乏尿性腎不全
omalgia	肩痛
omphalitis	臍炎
omphalocele	臍帯ヘルニア
oncocytoma	オンコサイトーマ
oncosis	腫瘍症
onychatrophy	爪萎縮
onychia	爪床炎
onychitis	爪床炎
onychocryptosis	爪嵌入症∥爪甲嵌入症
onychodystrophy	爪ジストロフィー∥爪甲異栄養症
onychogryposis	爪鉤湾症∥爪甲鉤湾症
onychoheterotopia	爪甲異所症
onycholysis	爪甲離床症∥爪離床症∥爪甲剥離症∥爪剥離症
onychomadesis	爪脱落症∥爪甲脱落症
onychomycosis	爪真菌症
onychopathy	爪疾患
onychorrhexis	爪裂症
onychoschizia	爪甲離症∥爪離症
onychotillomania	爪甲損傷癖∥爪甲引抜癖
oocyesis	卵巣妊娠(ovarian pregnancy)
oophoritis	卵巣炎
operational fatigue	操縦疲労
operculitis	弁蓋炎
ophthalmagra	痛風性眼痛
ophthalmomalacia	眼球軟化症
ophthalmoplegia	眼筋麻痺
ophthalmorrhagia	眼出血
optic neuritis	視神経炎
optic perineuritis	視神経外鞘炎
oral focal mucinosis	口腔病巣状粘液沈着症
orchialgia	精巣痛∥睾丸痛(orchiodynia; testalgia; didymalgia)
orchiodynia	精巣痛∥睾丸痛(orchialgia; testalgia; didymalgia)
orchiepididymitis	精巣上体炎∥睾丸副睾丸炎
orchiocatabasis	精巣下降(descensus testis)
orchiocele	精巣ヘルニア
orchiopathy	精巣疾患∥睾丸疾患
orchitis	精巣炎∥睾丸炎
oreximania	病的食欲亢進
organomegaly	臓器巨大症
oscheitis	陰嚢炎(scrotitis)
osmidrosis	臭汗症(bromidrosis)
osphyalgia	座骨神経痛
osseous torticollis	骨性斜頚 
osteitis	骨炎(ostitis)
osteitis deformans	変形性骨炎(ostitis deformans[L])
osteitis fibrosa cystica	嚢胞性線維性骨炎(ostitis fibrosa cystica)
osteoarthritis	骨関節炎
osteoarthritis deformans	変形性骨関節炎
osteoblastoma	骨芽細胞腫
osteochondroma	骨軟骨腫
osteoclastoma	破骨細胞腫
osteodentin	類骨象牙質
osteodynia	骨痛
osteodystrophy	骨異栄養症
osteogenesis imperfecta	骨形成不全症
osteogenic sarcoma	骨原性肉腫∥骨肉腫(osteosarcoma)
osteofluorosis	骨フッ素症
osteolysis	骨溶解
osteoma	骨腫
peripheral osteoma	末梢骨腫(osteoma periphericum[L])
osteoma durum	緻密骨腫
osteoma externa	外部骨腫
osteoma periphericum	末梢骨腫(peripheral osteoma)
osteoma spongiosum	海綿骨腫
osteomalacia	骨軟化症
osteomyelitis	骨髄炎
radiation osteomyelitis	放射線骨髄炎
suppurative osteomylitis	化膿性骨髄炎
osteopathy	骨障害∥骨症∥オステオパシー
osteopenia	骨希薄∥骨減少症
osteopetrosis	大理石骨病(marble bone disease)
osteophytosis	骨棘症∥骨増殖症
osteoporosis	骨粗鬆症∥骨多孔症
osteoradionecrosis	放射線骨壊死
osteosarcoma	骨肉腫(osteogenic sarcoma)
osteosclerosis	骨硬化(症)
ostitis	骨炎(osteitis)
ostitis deformans	変形性骨炎
ostitis fibrosa cystica	嚢胞性線維性骨炎
ostium secundum defect	二次口欠損症
otalgia	耳痛
otitis	耳炎
otitis externa	外耳炎
otitis interna	内耳炎
otitis media	中耳炎
otocephaly	耳頭症
otocleisis	耳閉鎖∥外耳道閉塞
otodynia	耳痛
otomycosis	耳真菌症
otoneuralgia	耳神経痛
otopathy	耳病∥耳疾患
otopyosis	耳化膿[症]
otorrhagia	耳出血
otorrhea	耳漏
ovarialgia	卵巣痛
ovarian fibroma	卵巣線維腫
ovarian pregnancy	卵巣妊娠(oocyesis)
ovariocele	卵巣瘤∥卵巣ヘルニア
ovariopathy	卵巣病
ovariorrhexis	卵巣破裂
ovaritis	卵巣炎
ozostomia	口臭
pachyblepharon	眼瞼肥厚(症)
pachycheilia	口唇肥厚(症)
pachydactyly	指趾肥厚
pachyderma	硬皮症
pachyglossia	厚舌症
pachyperiostitis	肥厚性骨膜炎
pachypleuritis	肥厚性胸膜炎
pachysalpingitis	肥厚性卵管炎
pachysalpingo-ovaritis	肥厚性卵管卵巣炎
pachyvaginalitis	肥厚性鞘膜炎
pachyvaginitis	肥厚性膣炎
paget's disease	パジェット骨病(osteitis deformans[L])
muscular pain	筋肉痛
referred pain	関連痛(telalgia)
palatitis	口蓋炎
palatoplegia	軟口蓋麻痺
palatoschisis	口蓋裂
palindromic rheumatism	回帰性リウマチ
palmar erythema	手掌紅斑(erythema palmare[L]//red palm)
palmar hyperhidrosis	手掌多汗(症)
palpebritis	眼瞼炎
panarthritis	汎関節炎
panbronchiolitis	汎細気管支炎
pancarditis	汎心炎
pancreatalgia	膵痛
pancreatic injury	膵損傷
pancreatitis	膵炎∥膵臓炎
pancreatolith	膵石∥膵結石∥膵臓結石
pancreatolithiasis	膵石症
pancreatopathy	膵疾患
pandemia	汎流行∥汎発流行
panencephalitis	全脳炎∥汎脳炎
panlobular emphysema	汎小葉性肺気腫(略 PE)
panniculitis	脂肪織炎
panotitis	全耳炎
panphlebitis	汎静脈炎
pantalgia	全身痛
papilledema	乳頭水腫∥乳頭浮腫
papilloma	乳頭腫
pigmented papilloma	色素性乳頭腫(seborrheic keratosis)
plexus papilloma	脈絡叢乳頭腫
papillomatosis	乳頭腫症
papillotubular adenoma	乳頭腺管腺腫
papillotubular carcinoma	乳頭腺管癌
papule	丘疹
papulosis	丘疹症
paracusia	錯聴[症]∥聴覚性錯覚(paracusis)
paracusis	錯聴[症]∥聴覚性錯覚(paracusia)
paraganglioma	傍神経節腫
parageusia	錯味(症)
paragnathus	下顎過剰症∥下顎結合奇形
paragonimiasis	肺吸虫症
paragrammatism	錯文法
paragraphia	錯書(症)
parakinesis	運動錯誤
parakeratosis	錯角化(症)
paralogia	錯論理(症)
paralysis	麻痺
postdiphtheritic paralysis	ジフテリア後麻痺
spastic paralysis	痙縮性麻痺
paralytic scoliosis	麻痺性側彎症
paralytic secretion	麻痺性分泌
parametritis	子宮傍結合織炎∥傍子宮炎
paranasal sinusitis	副鼻腔炎
paraparesis	不全対麻痺
paraplegia	対麻痺
parasite	寄生虫
parasitic enteritis	寄生虫性腸炎
parasitic enterocolitis	寄生虫性腸炎
parasitic stomatitis	寄生虫性口内炎
paratrichosis	異所生毛
paratyphlitis	盲腸周囲炎
paresis	不全麻痺
paresthesia	感覚異常[症]∥知覚異常[症]∥触覚性錯覚
paridrosis	発汗異常(症)
paronychia	爪郭炎∥爪壁炎
paronychomycosis	爪囲真菌症
paroophoritis	卵巣傍体炎∥傍卵巣炎
parophthalmia	眼傍結合組織炎∥眼周囲炎
parorexia	異物嗜好
parostosis	傍骨症
parotitis	耳下腺炎
chronic recurrent parotitis	慢性再発性耳下腺炎
paroxysmal dyspnea	発作性呼吸困難
paroxysmal dysrhythmia	特発性律動異常
partial block	不完全ブロック
patent ductus arteriosus	動脈管開存症
patent foramen ovale	卵円孔開存症
pathomimesis	仮病
pathosis	病的状態
pectoralgia	胸痛
pectus excavatum	漏斗胸(funnel chest; chonechondrosternon; koilosternia)
pedialgia	足痛
pediculosis	シラミ寄生症
pelvospondylitis	骨盤脊椎炎
pemphigus	天疱瘡
pemphigus erythematosus	紅斑性天疱瘡(略 Pe)
pemphigus foliaceus	落葉性天疱瘡
pemphigus vulgaris	尋常性天疱瘡
pemphigoid	類天疱瘡
peptic ulcer	消化性潰瘍
perforated gastric ulcer	穿孔性胃潰瘍
perforated peptic ulcer	消化性潰瘍穿孔
perforation	穿孔
periadenitis	腺周囲炎
periangiocholitis	胆管周囲炎
periapical scar	根尖瘢痕[[歯]]
periarteritis	動脈周囲炎
periarteritis nodosa	結節性動脈周囲炎(略 *PN)
periarthritis	関節周囲炎
scapulohumeral periarthritis	肩関節周囲炎(periarthritis scapulohumeralis[L])
pericarditis	心外膜炎∥心嚢炎
pericementitis	根尖性セメント周囲炎[[歯]]
pericholangitis	胆管周囲炎
pericholecystitis	胆嚢周囲炎
perichondritis	軟骨膜炎
pericolitis	結腸周囲炎
pericolpitis	膣周囲炎
pericoronitis	歯冠周囲炎
periductal masititis	乳管周囲炎
perilaryngitis	喉頭周囲炎
perimetritis	子宮周囲炎∥子宮外膜炎
perinephritic abscess	腎周囲膿瘍
perinephritis	腎周囲炎
perineuritis	神経周囲炎
periorbititis	眼窩骨膜炎
periodontitis	歯周炎
traumatic periodontitis	外傷性歯周炎
perioophoritis	卵巣周囲炎
periosteomyelitis	骨膜骨髄炎
periostitis	骨膜炎
periostosis	骨膜症
perirectal abscess	肛門周囲膿瘍∥直腸周囲膿瘍
perisalpingitis	卵管周囲炎
perisigmoiditis	Ｓ状結腸周囲炎
perisplenitis	脾周囲炎
perispondylitis	脊椎周囲炎
peritendinitis	腱鞘炎
peritonealgia	腹膜痛
peritonitis	腹膜炎
peritonsillitis	扁桃周囲炎
peritracheitis	気管周囲炎
perityphlitis	盲腸周囲炎
perivaginitis	膣周囲炎
perivasculitis	血管周囲炎
peromelia	四肢奇形(peromely)
peromely	四肢奇形(peromelia)
pertussis	百日咳(whooping cough)
pes valgus	外反足(talipes valgus)
petroclival meningioma	斜台錐体部髄膜腫
petrosal neuralgia	錐体神経痛
petrositis	錐体炎
phacoma	水晶体腫
phallitis	陰茎炎
pharyngalgia	咽頭痛
pharyngitis	咽頭炎
pharyngoconjunctival fever	咽頭結膜熱(略 *PCF)
pharyngodynia	咽頭痛
pharyngomycosis	咽頭糸状菌症
pharyngoplegia	咽頭麻痺
pharyngorrhea	咽頭漏
pharyngotonsillitis	咽頭扁桃炎
pharyngoxerosis	咽頭乾燥症
pheochromoblastoma	クロム親和芽細胞腫
pheochromocytoma	クロム親和細胞腫
phlebangioma	静脈瘤
phlebarteriectasia	動静脈拡張症
phlebectasia	静脈拡張症
phlebemphraxis	静脈血栓症∥静脈塞栓症
phlebismus	静脈怒張
phlebitis	静脈炎
phlebolith	静脈石∥静脈結石
phlebolithiasis	静脈結石症
phlebosclerosis	静脈線維症(venofibrosis)
phlebostasis	静脈鬱血(venous stasis; venostasis; venous congestion)
phlebothrombosis	静脈血栓症(venous thrombosis)
phlebothrombus	静脈血栓
phlegmon	蜂巣織炎
photophobia	光恐怖症
phrenic nerve palsy	横隔神経麻痺
phrenoplegia	横隔膜麻痺
phthisis	癆〈結核のこと〉
phthisis pulmonum	肺癆[L]〈肺結核のこと〉
phycomycosis	藻菌症
physioneurosis	真性神経症
physocele	含気腫瘍∥含気ヘルニア嚢
physopyosalpingx	卵管膿気腫
pigmentation	色素沈着
pigmentovascular vevus	色素血管性母斑
pilomatrixoma	毛母腫∥毛質腫
pilosis	多毛症
pinealoblastoma	松果体芽細胞腫
pinealoma	松果体腫
pituicytoma	下垂体細胞腫
pituitary gigantism	下垂体性巨人症
placenta accreta	癒着胎盤
placenta increta	侵入胎盤
placenta percreta	穿通胎盤
placenta previa	前置胎盤
placental abruption	胎盤早期剥離
placental polyp	胎盤ポリープ
placental site trophoblastic tumor	胎盤性栄養膜細胞腫瘍[略 PSTT]
placentitis	胎盤炎
placentoma	胎盤腫
pladaroma	眼瞼軟疣腫
plagiocephaly	斜頭症
planovalgus	扁平外反
plantar fasciitis	足底腱膜炎
plantar wart	足底いぼ(verruca plantaris[L])
plasmacytoma	形質細胞腫
plasmacytosis	形質細胞増加症
pleomorphic adenoma	多形性腺腫
pleomorphic sarcoma	多形性肉腫∥多形型肉腫
pleuralgia	胸膜痛
pleurisy	胸膜炎(pleuritis)
pleuritis	胸膜炎(pleurisy)
pleuritis carcinomatosa	癌性胸膜炎
pleuritis sicca	乾性胸膜炎(dry pleurisy)
pleurocele	胸膜瘤
pleurodynia	胸膜痛(pleuralgia)
pleurolith	胸膜結石
pleuropericarditis	胸膜心膜炎
pleuropneumonia	胸膜肺炎
pleurorrhea	胸腔漏
pneumarthrosis	関節気腫
pneumatocele	気瘤(aerocele)
pneumatorrhachis	脊椎気腫
pneumatosis	気腫[症]∥気症
pneumaturia	気尿(症)
pneumocephalus	頭蓋内気腫
pneumococcal otitis media	肺炎球菌性中耳炎
pneumococcal empyema	肺炎球菌性蓄膿
pneumoconiosis	塵肺(症)
pneumocranium	気脳[症]; 頭蓋内気腫
pneumocystis carinii pneumonia	カリニ肺炎
pneumocystosis	ニューモシスチス症
pneumomediastinum	気縦隔(症)
pneumomycosis	肺真菌症
pneumonectasia	肺気腫
pneumonia	肺炎(pneumonitis)
hypersensitivity pneumonia	過敏性肺炎
radiation pneumonia	放射線肺炎
staphylococcal pneumonia	黄色ブドウ球菌[性]肺炎
uremic pneumonia	尿毒症性肺炎
viral pneumonia	ウイルス性肺炎
pneumonitis	肺炎
pneumoperitonitis	含気性腹膜炎
pneumopleuritis	肺胸膜炎
pneumosclerosis	肺硬化症
pneumothorax	気胸
traumatic pneumothorax	外傷性気胸
podalgia	足痛
podarthritis	足関節炎
poikilocytosis	変形赤血球症
poikiloderma	多形皮膚萎縮(症)
poisoning	中毒(intoxication)
poliodystrophy	灰白質萎縮(症)
polioencephalitis	灰白脳炎
polioencephalomeningomyelitis	灰白脳脊髄髄膜炎
polioencephalomyelitis	灰白脳脊髄炎
polioencephalopathy	灰白脳症
poliomyelitis	脊髄性小児麻痺
poliosis	白毛(症)
polyangiitis	多発性血管炎
polyarteritis	多発性動脈炎
polyarteritis nodosa	結節性多発動脈炎∥多発性結節性動脈炎[L][略 PN]
polyarthralgia	多発性関節痛
polyarthritis	多発性関節炎
polycholia	胆汁過多(症)
polycystic kidney	多嚢胞腎∥嚢胞腎(multicystic kidney)
polycythemia	赤血球増加[症]∥多血症
polycythemia vera	真性多血症
polydipsia	多飲多食症
polydysplasia	多発異形成
polyglobulism	多血球症
polygnathia	多顎症
polyhidrosis	多汗(症)(hyperhidrosis)
polymastia	多乳房症
polymenorrhea	頻発月経
polymeria	多節(症)
polymyalgia	多発性筋肉痛
polymyositis	多発性筋炎
polyneuralgia	多発性神経痛
polyneuritis	多発性神経炎
polyneuromyositis	多発性神経筋炎
polyneuropathy	多発性神経障害∥多発性ニューロパチー
polyp	息肉∥ポリープ
polypathia	多病
polyphagia	大食症
polyplegia	多発性麻痺
polypnea	多呼吸
polypodia	多足症
polyposis	ポリープ症∥ポリポシス
polysplenia	多脾症
polysyndactyly	多合指症
polyuria	多尿症
pontine infarction	橋梗塞
porencephaly	孔脳症
porokeratosis	汗孔角化(症)
poroma	1.炎症性硬結; 2.汗孔腫
porphyria	ポルフィリン症(hematoporphyria)
porphyria cutanea tarda	晩発性皮膚ポルフィリン(略 PCT)
postmenopausal bleeding	閉経後出血(略 PMB)
postmenopausal syndrome	閉経後症候群(略 PMS)
postoperative buccal cyst	術後頬部嚢胞
postpartum depression	産後うつ病
postrenal anuria	腎後性無尿
postrenal hematuria	腎後性血尿
postrenal uremia	腎後性尿毒症
posttraumatic amnesia	外傷後健忘
posttraumatic hydrocephalus	外傷後水頭症
pouchitis	回腸嚢炎
precancerous lesion	前癌病変
precordialgia	前胸部痛
preexcitation	早発興奮(症)
pregnancy granuloma	妊娠腫(granuloma gravidarum[L])
preleukoplakia	前白板症
premalignant lesion	前癌病変
preurethritis	前尿道炎
pregnancy epulis	妊娠エプーリス(epulis granidarum[L])
pregnancy tumor	妊娠腫
primary atypical pneumonia	原発性異型肺炎[略 PAP]
primary glomerular disease	原発性糸球体疾患
primary hepatocarcinoma	原発性肝癌
primary tuberculosis	一次性結核
proctalgia	肛門直腸痛∥直腸肛門痛
proctocele	直腸脱
proctodynia	直腸肛門痛
proctoplegia	肛門括約筋麻痺
proctoptoma	肛門脱∥脱肛
proctoptosis	肛門脱∥脱肛
proctostenosis	直腸狭窄症∥直腸狭窄(rectostenosis)
progeria	早老症
prolapse	脱出(症)
urethral prolapse	尿道脱
prolapsus	脱出(症)
prolapsus ani	脱肛(proctoptosis; proctoptoma)
prolapsus recti	直腸脱
prolapsus uteri	子宮脱
prolapsus vaginae	膣脱
proliferating retinopathy	増殖型網膜症
proliferative glomerulonephritis	増殖性糸球体腎炎
prolonged apnea	持続無呼吸
proptosis	眼球突出(exophthalmia//exophthalmos//exophthalmus)
prosopodysmorphia	顔面変形症
prosopoplegia	顔面筋麻痺
prosoposchisis	顔面裂
prosopospasm	顔面筋痙攣
proteinosis	蛋白症
protozoal myocarditis∥protozoan myocarditis	原虫性心筋炎
protozoal infection∥protozoan infection	原虫感染症∥原虫症(protozoiasis; protozoosis)
protuberant dermatofibrosarcoma	隆起性皮膚線維肉腫(dermatofibrosarcoma protuberans[L])
psammoma	砂腫
psammosarcoma	砂腫状肉腫(sarcoma psammosum[L])
pseudarthrosis	偽関節
pseudoankylosis	偽性強直(症)
pseudocyst	偽嚢胞
pseudofracture	偽性骨折
pseudogout	偽痛風
pseudolupus	偽狼瘡
pseudoluxation	仮性脱臼
pseudomembranous colitis	偽膜性大腸炎(略 PMC)
pseudomembranous gastritis	偽膜性胃炎
pseudomembranous inflammation	偽膜性炎
pseudomyopia	仮性近視
pseudopelade	萎縮性脱毛(症)
psittacosis	オウム病
psoriasis	乾癬
psoriasis pustulosa	膿疱性乾癬
psoriasis vulgaris	尋常性乾癬
psoriatic erythroderma	乾癬性紅皮症(erythroderma psoriaticum[L])
psychalgia	精神痛
psychologic dyspareunia	心因性冷感症
psychosomatic disorder	心身障害
psychoplegia	精神麻痺
psychosis	精神病
ptosis	下垂(症)
ptyalism	流唾(症)
puerperal tetanus	産褥破傷風
pulmonary alveolar proteinosis	肺胞蛋白症(略 PAP)
pulmonary collapse	肺虚脱
pulmonary congestion	肺うっ血
pulmonary contusion	肺挫傷(lung contusion)
pulmonary damage	肺損傷(lung damage)(lung injury)
pulmonary disease	肺疾患(lung disease)
pulmonary edema	肺水腫∥肺浮腫
pulmonary emphysema	肺気腫(略 PE)
pulmonary eosinophilia	肺好酸球症(略 PE)
pulmonary fibroproliferation	肺線維増殖症(略 PFP)
pulmonary sequestration	肺分画症∥肺分離症
pulmonary silicosis	硅肺症
pulmonic plague	肺ペスト(pneumonic plague)
pulpalgia	歯髄痛
pulpitis	歯髄炎
pulpoperiapical disease	歯髄根尖周囲疾患
pulseless disease	脈なし病(Takayasu's disease)
pupillary dilatation	瞳孔散大
pupillary disturbance	瞳孔障害
purpura	紫斑病
thrombocytopenic purpura	血小板減少性紫斑病
purpura fulminans	劇症性紫斑病
pustule	膿疱
pustulosis	膿疱症
putaminal hemorrhage	被殻出血
pyelitis	腎盂炎
pyelolith	腎盂結石
pyelolithiasis	腎盂結石症
pyelonephritis	腎盂腎炎
pyelonephrosis	腎盂腎症
pyemesis	吐膿症
pyemia	膿血症
pyesis	化膿(症)(suppuration)
pygalgia	臀痛
pyloric stenosis	幽門狭窄(pyloristenosis)
pyloristenosis	幽門狭窄(pyloric stenosis)
pyloritis	幽門炎
pyocalyx	腎杯蓄膿
pyocyst	膿嚢胞
pyoderma	膿皮症(pyodermia; pyodermatosis)
pyoderma gangrenosum	壊疽性膿皮症(略 PG)
pyodermatosis	膿皮症(pyoderma; pyodermia)
pyodermia	膿皮症(pyoderma; pyodermatosis)
pyogenesis	化膿∥膿形成
pyogenic spondylitis	化膿性脊椎炎(＝感染性脊椎炎∥細菌性脊椎炎)
pyolabyrinthitis	化膿性迷路炎
pyometritis	化膿性子宮炎
pyomyositis	化膿性筋炎
pyonephrosis	膿腎症
pyo-ovarium	卵巣膿瘍
pyopericarditis	化膿性心膜炎∥化膿性心嚢炎
pyoperitonitis	化膿性腹膜炎
pyophthalmia	膿眼
pyophthalmitis	膿眼
pyopneumothorax	膿気胸
pyopoiesis	化膿∥膿形成
pyorrhea	膿漏(症)
pyosalpingx	卵管膿腫
pyosis	化膿(症)
pyospermia	膿精液症
pyostomatis	化膿性口内炎
pyoureter	膿尿管∥尿管蓄膿
pyovesiculosis	精嚢蓄膿
pyuria	膿尿(症)
q fever	Q熱
quadriplegia	四肢麻痺(tetraplegia)
quinsy	扁桃周囲膿瘍∥扁桃膿瘍(peritonsillar abscess)
quotidian fever	毎日熱
quotidian malaria	毎日熱マラリア
rachialgia	背痛
rachischisis totalis	全脊椎裂
radial deviation	橈屈
radiation cystitis	放射線膀胱炎(radiocystitis)
radiation dermatitis	放射線皮膚炎(radiodermatitis)
radiation leukemia	放射線白血病
radiation mucositis	放射線粘膜炎
radiation neuritis	放射線神経炎(radioneuritis)
radiation pneumonitis	放射線肺臓炎
radiodermatitis	放射線皮膚炎
radionecrosis	放射線壊死
radioneuritis	放射線神経炎
ranula	ガマ腫∥ラヌラ
rash	発疹∥皮疹(skin rash)
reactive perforating collagenosis	反応性穿孔性膠原症
rectal stricture	直腸狭窄
rectal ulcer	直腸潰瘍
rectalgia	直腸痛
rectorrhagia	直腸出血(proctorrhagia)
recurrent polyneuritis	反復性多発性神経炎
red palm	手掌紅斑(palmar erythema//erythema palmare[L])
redness	発赤
reflective ptyalism	反射性流唾症
reflective toothache	反射性歯痛
refractory jaundice	難治性黄疸
refractory periodontitis	〔歯〕難治性歯周炎
renal calculus	腎結石
renal glycosuria	腎性糖尿
renal insufficiency	腎不全(renal failure)
renal tuberculosis	腎結核
retained placenta	停留胎盤∥胎盤残留∥胎盤遺残∥胎盤停滞
retained testis	停留睾丸∥停留精巣(undescended testis; retentio testis[L]; cryptorchidism)
retentio testis	停留睾丸∥停留精巣[L](=undescended testis; retained testis; cryptorchidism)
retention jaundice	停留性黄疸
retention polyp	停留ポリープ
retinal separation	網膜剥離
reticulocyte	網状赤血球
retinitis	網膜炎
retinitis pigmentosa	色素性網膜炎
retinoblastoma	網膜芽細胞腫∥網膜芽腫
retinomalacia	網膜軟化症
retinopapillitis	乳頭網膜炎
retinopathy	網膜症
radiation retinopathy	放射線網膜症
retinopathy of prematurity	未熟児網膜症
retinoschisis	網膜分離症
retinosis	網膜症
retractile testis	移動性精巣
retrogenia	下顎後退(症)
retroperitoneal hematoma	後腹膜血腫∥腹膜後血腫
retroplasia	退行形成
rhabdomyoma	横紋筋腫
rhabdomyosarcoma	横紋筋肉腫
rheumatic pleurisy	リウマチ性胸膜炎
rheumatic myocarditis	リウマチ性心筋炎
rheumatic pneumonia	リウマチ性肺炎
rheumatic purpura	リウマチ性紫斑病
rheumatoid arthritis	リウマチ性関節炎
rheumatosis	リウマチ[性]疾患
rhinalgia	鼻痛
rhinitis	鼻炎
rhinoantritis	鼻洞炎
rhinocleisis	鼻腔狭窄(症)
rhinolith	鼻石
rhinomycosis	鼻糸状菌症
rhinopathy	鼻症∥鼻障害
rhinopharyngitis	鼻咽頭炎
rhinorrhagia	鼻血
rhinorrhea	鼻漏
rhinosinusitis	鼻副鼻腔炎
rhinosporidiosis	リノスポリジウム症
rhinostenosis	鼻腔狭窄(症)
rhinotracheitis	鼻腔気管炎∥鼻気管炎
rib fracture	肋骨骨折
rickettsial pneumonia	リケッチア性肺炎
right atrioventricular valve atresia	右房室弁閉鎖症
right heart failure	右心不全
rodent ulcer	蚕食性潰瘍
root pain	神経根痛∥根性痛
rubella	風疹
rupture of Achilles tendon	アキレス腱断裂
sacrococcygeal teratoma	仙尾部奇形腫
salivary calculus	唾石(salivary stone; sialolith)
salivary stone	唾石(salivary calculus; sialolith)
salpingemphraxis	卵管閉塞症
salpingitis	卵管炎
salpingocele	卵管ヘルニア
salpingolith	卵管結石
salpingolithiasis	卵管結石症
salpingoperitonitis	卵管腹膜炎
sarcoidosis	類肉腫症
sarcoma	肉腫
sarcoma psammosum	砂腫状肉腫[L](=psammosarcoma)
sarcomatosis	肉腫症
scaly leg	鱗状脚
scaphocephalia	舟状頭症∥舟状頭蓋奇形
scaphoiditis	舟状骨炎
scapulalgia	肩甲骨痛
scarlet fever	猩紅熱
scatoma	糞腫
scatophagy	食糞症
scelalgia	脛痛
schistocystis	膀胱裂
schistoglossia	舌裂
schistosomiasis	住血吸虫症
schizodontism	裂歯症
schwannoma	神経鞘腫
sciatic neuritis	坐骨神経炎
sciatica	坐骨神経痛(sciatic pain; ischialgia; ischiodynia)
scleredema	硬水腫
scleritis	強膜炎
sclerodentin	硬化象牙質
scleroderma	強皮症∥皮膚硬化症
systemic scleroderma	全身性強皮症∥全身性皮膚硬化症
scleroma	硬化腫
scleroma neonatorum	新生児硬化腫
scleronychia	爪硬化症
sclerotic gastritis 	硬化性胃炎
sclerotic osteitis 	硬化性骨炎
sclerotic tongue 	硬化舌
scoliosis	側彎症
scrotal eczema	陰嚢湿疹
scrotal elephantiasis	陰嚢象皮病
scrotal hernia	陰嚢ヘルニア(scrotocele)
scrotitis	陰嚢炎(oscheitis)
scrotocele	陰嚢ヘルニア(scrotal hernia)
sebaceous adenoma	脂腺腫
seborrhea	脂漏(症)
seborrheic blepharitis	脂漏性眼瞼炎
seborrheic dermatitis	脂漏性皮膚炎
seborrheic keratosis	脂漏性角化症(keratosis seborrheica[L])
seborrhoea sicca	乾性脂漏症
seborrheic wart	脂漏性疣
secodont	切縁歯
selenodont	半月歯
senile keratoma	老人性角化腫[略 KS]
sensory aphasia	感覚性失語(症)
sensory apraxia	感覚性失行(症)
sensory ataxia	感覚性運動失調
sensory epilepsy	感覚性癲癇
sepsis	敗血症(形 septic) (septicemia)
septic shock	敗血症性ショック
septicemia	敗血症(sepsis)
septicopyemia	膿敗血症
septimetritis	敗血性子宮炎
serocele	漿液瘤
serositis	漿膜炎
serous adenoma	漿液性腺腫
serous adenocarcinoma	漿液性腺癌
serous cystoma	漿液性嚢腫
serous otitis media	漿液性中耳炎
serous papillary adenocarcinoma	漿液性乳頭状腺癌
serous pulpitis	漿液性歯髄炎
serum rash	血清疹
serum sickness	血清病
sesamoiditis	種子骨炎
shigellosis	シゲラ感染症∥細菌性下痢
shingles	帯状疱疹(herpes zoster)
shock	ショック
sialadenoma papilliferum	乳頭状唾液腺腫[L]
sialemesia	吐唾症
sialolith	唾石(salivary calculus; salivary stone)
sialolithiasis	唾石症
sialometaplasia	唾液腺化生
sialorrhoea	流涎
sickle cell anemia	鎌状赤血球貧血
signet-ring cell carcinoma	印環細胞癌
silicosis	硅粉症
simple pulmonary eosinophilia	単純性肺好酸球増加症∥単純性肺好酸球増加
sinus infection	静脈洞感染∥副鼻腔感染∥洞感染
sinus phlebitis	静脈洞炎
sinusitis	洞炎
skelalgia	脚痛
skin abscess	皮下膿瘍(cutaneous abscess; subcutaneous abscess)
skin cancer	皮膚癌
skin rash	皮疹(rash)
slipped vertebra	脊椎すべり症
smallpox	天然痘∥痘瘡(variola)
solar keratosis	日光性角化症(actinic keratosis)
solar retinopathy	日光性網膜症
somatomegaly	巨人症
somnolence	傾眠(somnolency)
somnolency	傾眠(somnolence)
somnolentia	1.傾眠(somnolence; somnolency)
somnolism	催眠状態
spasm	痙攣∥攣縮
spermatic cord torsion	精索捻転症
spermatocystitis	精嚢炎
spermatitis	精管炎∥精索炎
spermatocele	精液瘤
spermatocyst	精液瘤(spermatocele)
spermatolysis	精子溶解
spermatopathia	精液病∥精子病
spermaturia	精液尿症
spermolith	精管結石
spermoneuralgia	精索神経痛
spermophlebectasia	精索静脈瘤
sphincteritis	括約筋炎
sphingolipidosis	スフィゴリピドシス∥スフィゴリピド症∥スフィゴ脂質症
sphingomyelinosis	スフィンゴミエリン症
spinal canal stenosis	脊柱管狭窄症∥脊柱管狭窄(spinal stenosis)
spinal cord herniation	脊髄ヘルニア
spinal fracture	脊椎骨折
spinal hemiplegia	脊髄半側麻痺∥脊髄片麻痺
spinal paralysis	脊髄麻痺(myeloparalysis; myeloplegia)
spinal rachischisis	脊椎披裂∥脊椎裂(rachischisis)
spinal stenosis	脊柱管狭窄症∥脊柱管狭窄(spinal canal stenosis)
spinal syphilis	脊髄梅毒(myelosyphilis)
spinalgia	脊髄痛
spiradema	汗腺腫
splanchnocele	内臓ヘルニア
splanchnodiastasis	内臓分離∥内臓転位
splanchnolith	内臓結石
splanchnomegaly	内臓巨大症
splanchnopathy	内臓疾患∥内臓障害
splenalgia	脾臓痛
splenectasis	脾腫大
splenic injury	脾損傷
splenitis	脾炎
splenodynia	脾臓痛
splenomalacia	脾軟化症
splenomegaly	脾腫大∥巨脾症
splenoptosis	脾下垂(症)
splenorrhagia	脾出血
splenosis	脾症
spondylalgia	脊椎痛
spondylarthritis	脊椎関節炎
spondylarthrosis	脊椎関節症
spondylitis	脊椎炎
spondylizema	脊椎陥没(症)
spondylocace	脊椎結核∥脊椎カリエス
spondylodynia	脊椎痛
spondylolysis	脊椎分離(症)
spondylomalacia	脊椎軟化(症)
spondylomalacia traumatica	外傷性脊椎軟化(症)
spondylomyelitis	脊椎脊髄炎
spondyloptosis	脊椎下垂(症)
spondylopathy	脊椎症
spondylopyosis	脊椎化膿(症)
spondyloschisis	脊椎披裂∥脊椎裂
spondylosis	脊椎症
spondylosis deformans	変形性脊椎症
spondylosyndesis	脊椎癒着
spontaneous dislocation	特発脱臼
spontaneous fracture	特発性骨折
spontaneous hepatic rupture	自発[性]肝破裂(spontaneous liver rupture)
spontaneous liver rupture	自発[性]肝破裂(spontaneous hepatic rupture)
sports injuries	スポーツ障害[pl]
spotted fever	斑点熱
sputum cruentum	血痰
squint	斜視
staphylitis	口蓋垂炎(uvulitis)
staphylococcemia	葡萄球菌血[症]=ブドウ球菌血(症)
staphyloma	葡萄膜腫∥葡萄腫
staxis	出血
steatocele	脂肪瘤
steatohepatitis	脂肪性肝炎
steatolysis	脂肪融解
steatonecrosis	脂肪壊死
steatopygia	殿部脂肪過多[症]∥殿部脂肪蓄積
steatorrhea	1.皮脂漏; 2.脂肪便∥脂肪性下痢[Br steatorrhoea]/[2](=fatty diarrhea) /漏=ろう/
stenosis	狭窄(症)
stercolith	糞石∥腸石∥腸結石
stereoagnosis	立体認知不能
sternalgia	胸骨痛
stethalgia	胸痛(chest pain)
stillbirth	死産(dead birth)
stomatitis	口内炎
uremic stomatitis	尿毒症性口内炎
stomatitis diphtheriae	ジフテリア性口内炎
stomatomycosis	口腔真菌症
storage disease	蓄積症
streptococcemia	連鎖球菌血症
streptococcosis	連鎖球菌症
stress fracture	疲労骨折
stupor	昏迷∥無感覚∥麻瘁∥人事不省
subacute hepatitis	亜急性肝炎(略 SAH)
subacute rheumatism	亜急性リウマチ
subacute thyroiditis	亜急性甲状腺炎
subalimantation	低栄養
subcutaneous abscess	皮下膿瘍(cutaneous abscess; skin abscess)
subdural hygroma	硬膜下水腫 
subependymoma	上衣下腫
subepidermal abscess	表皮下膿瘍
subinfection	亜感染症
subinvolution of uterus	子宮復古不全(症)
subluxation	亜脱臼∥不全脱臼
subluxation of head of radius in child	肘内障
subluxation of shoulder	肩関節亜脱臼
submucosal tumor of esophagus	食道粘膜下腫瘍
submucous myoma	子宮粘膜下筋腫
subnutrition	低栄養
subphrenic abscess	横隔膜下膿瘍
subretinal hemorrhage	網膜下出血
suffocation	窒息(asphyxia)
supraventricular arrhythmia	上室性不整脈
supraventricular extrasystole	上室性期外収縮
supraventricular tachycardia	上室性頻脈
suppurative mastoiditis	化膿性乳突炎
surgical liver bleeding	外科的肝[臓]出血
survivor syndrome	生存者症候群
swaying gait	動揺歩行
swelling	腫大∥腫脹
sycosis	毛瘡
symblepharon	眼瞼癒着(blepharosynechia; ankyloblepharon)
symmelia	合肢症∥人魚体症∥下肢癒着症
symmelus	合肢体∥人魚体∥下肢癒着体
symptomatic anemia	症候性貧血(secondary anemia)
syncanthus	眼角眼球癒着
syncephalalus	頭部結合体
syncope	失神
syndactyly	合指症
syndesmitis	靭帯炎
synoscheos	陰茎陰嚢癒着(症)
synostosis	骨癒合症∥骨癒合
synotia	合耳症
synovial sarcoma	滑膜肉腫
synovioma	滑膜腫
synoviosarcoma	滑膜肉腫
synovitis	滑膜炎
syphilitic aortitis	梅毒性大動脈炎
syphilitic glossitis	梅毒性舌炎
syphilitic meningitis	梅毒性髄膜炎
syphilitic stomatitis	梅毒性口内炎
syphilis	梅毒
syringadenoma	汗腺腫(syringoadenoma)
syringocarcinoma	汗腺癌
syringitis	耳管炎
syringoadenoma	汗腺腫(syringadenoma)
syringocele	脊髄瘤(myelocele)
syringomyelia	脊髄空洞症
syringomyelitis	炎症性脊髄空洞症
syringomyelocele	空洞状脊髄脱出
systemic rheumatism	全身性リウマチ
systemic side effect	全身性副作用
systemic vein stenosis	体静脈狭窄
tabes dorsalis	脊髄癆
tachyarrhythmia	頻拍性不整脈
tachycardia	頻脈
tachylalia	速語症
tachyphagia	速食症
tachyphrasia	速語症
tachypnea	頻呼吸∥多呼吸
Takayasu arteritis	高安動脈炎
Takayasu disease	脈なし病(pulseless disease)
talcosis	滑石沈着(症)
talipes	彎足∥彎曲足
talipes calcaneovalgus	外反踵足
talipes calcaneus	踵足
talipes valgus	外反足(pes valgus)
talipes varus	内反足
talipomanus	彎曲手
talipomanus extensa	伸展彎曲手
talipomanus flexa	屈曲手
talipomanus valga	外反手
talipomanus vara	内反手
taeniasis	条虫症
tarsalgia	足根痛
tarsitis	眼瞼炎
telalgia	関連痛(referred pain)
telangiectasis	毛細血管拡張(症)
telangioma	毛細血管腫
telangiosis	毛細血管症
telecanthus	眼角離開
temporomandibular dysfunction	顎関節機能障害∥顎関節機能異常
tendinitis	腱炎
tendovaginitis	腱鞘炎
teratocarcinoma	奇形癌
teratoma	奇形腫
tetanus	破傷風
tetany	強直∥テタニー
tetrabrachius	四腕奇形児
tetraplegia	四肢麻痺(quadriplegia)
tetralogy of Fallot	ファロー四徴症
tetramazia	二重乳房
tetrapus	四足体
tetrotus	四耳体
thalassemia	地中海貧血∥サラセミア
thallotoxicosis	タリウム中毒(症)
thelitis	乳頭炎
thelorrhagia	乳頭出血
thermalgia	灼熱痛
thermoplegia	熱射病
thoracic aortic aneurysm	胸部大動脈瘤(略 TAA)
thoracic kidney	胸部腎
thoracic outlet syndrome	胸郭出口症候群(略 TOS)
thoracopathy	胸部疾患
thrombocythemia	血小板血症∥栓球血症
thrombocytopenia	血小板減少(症)
thrombocytosis	血小板血症∥栓球血症
thromboembolism	血栓塞栓症
thromboendarteritis	血栓性動脈内膜炎
thrombophlebitis	血栓性静脈炎
thrombosis	血栓症
thrombostasis	血小板鬱滞症∥血小板鬱滞
thymic hypertrophy	胸腺肥大
thymitis	胸腺炎
thymomic carcinoma	胸腺癌
thymoma	胸腺腫
thyroadenitis	甲状腺炎
thyroiditis	甲状腺炎
tibia valga	外反脛骨
tibia vara	内反脛骨
tinea pedis	水虫(athlete's foot)
tinea unguium	爪白癬(nail ringworm)
tinnitus	耳鳴り∥耳鳴
tonsillitis	扁桃炎
tonsillolith	扁桃結石
tonsillopharyngitis	扁桃咽頭炎 
topoanesthesia	部位感覚消失
tooth fracture	歯折
torsion	捻転(症)
torticollis	斜頚(collum distortum[L])
toxic anemia	中毒性貧血
toxic asthma	中毒性喘息
toxic atrophy	中毒性萎縮
toxic constipation	中毒性便秘
toxic deafness	中毒性難聴
toxic eczema	中毒性湿疹
toxic edema	中毒性水腫∥中毒性浮腫
toxic erythema	中毒性紅斑
toxic hepatitis	中毒性肝炎
toxic liver cirrhosis	中毒性肝硬変
toxic megacolon	中毒性巨大結腸症
toxic nephropathy	中毒性腎症
toxic nodule	中毒性結節
toxic psychosis	中毒精神病(*体内の毒素による)
toxic reaction	中毒反応
toxic shock	中毒性ショック
toxic shock syndrome	中毒性ショック症候群
toxic tremor	中毒性振戦
tracheal fistula	気管瘻
tracheal foreign body	気管異物
tracheitis	気管炎
trachelitis	子宮頚炎
trachelopanus	1.頚部リンパ管拡張; 2.子宮頚部リンパ管拡張
tracheobronchial adenopathy	気管気管支リンパ節疾患 
tracheomalacia	気管軟化(症)
tracheopathy	気管疾患
tracheostoma	気管瘻∥気管フィステル(形 tracheostomal)
trauma	外傷
traumatism	外傷状態
traumatic bone fracture	外傷性骨折(traumatic fracture)
traumatic brain injury	外傷性脳損傷
traumatic erythrodontia	外傷性紅変歯
traumatic hemothorax	外傷性血胸
traumatic cervical syndrome	外傷性頚部症候群
traumatic occlusion	外傷性咬合
traumatic perforation of appendix	外傷性虫垂穿孔
traumatic ulcer	外傷性潰瘍
traumatopnea	外傷性呼吸困難
trichiasis	睫毛乱生(症)
trichoepithelioma	毛包上皮腫
trichoglossia	毛舌(症)
trichologia	抜毛癖
trichophytosis	白癬(症)
trichopoliodystrophy	白髪ジストロフィー
trichotilomania	抜毛癖∥トリコチロマニー
trigeminy	三段脈
trigger finger	弾発指∥ばね指
trigonocephaly	三角頭
triplegia	三肢麻痺
triplopia	三重視
tropical pulmonary eosinophilia	熱帯性肺好酸球増加症∥熱帯性肺好酸球増加
true cyst	真性嚢胞
tubatorsion	卵管捻転
tuberculation	結核形成
tuberculoma	結核腫
tuberculosis	結核
mult-drug resistant tuberculosis	多薬物耐性結核
tuberculous abscess	結核性膿瘍
tuberculous pleuritis	結核性胸膜炎
tuberculous arthritis	結核性関節炎
tuberculous glossitis	結核性舌炎
tuberculous keratitis	結核性角膜炎
tuberculous lymphadenitis	結核性リンパ節炎
tuberculous nephritis	結核性腎炎
tuberculous pericarditis	結核性心膜炎
tuberculous peritonitis	結核性腹膜炎
tuberculous rheumatism	結核性リウマチ
tuberculous salpingitis	結核性卵管炎
tuberculous spondylitis	結核性脊椎炎
tuberculous submandibular lymphadenitis	結核性顎下リンパ節炎
tularemia	野兎病
benign tumor	良性腫瘍
malignant tumor	悪性腫瘍
tussiculation	短い空咳∥頻発軽咳
tyloma	胼胝∥皮膚肥厚
tympanic perforation	鼓膜穿孔
tympanitis	鼓室炎
tympanosclerosis	鼓膜硬化(症)
typhlatony	盲腸弛緩(症)
typhlectasis	盲腸拡張(症)
typhlocolitis	盲腸結腸炎
typhlodicliditis	回盲弁炎
typhlomegaly	盲腸巨大(症)
typhloptosis	盲腸下垂(症)
typhlostenosis	盲腸狭窄(症)
ulcer	潰瘍
ulceration	潰瘍化∥潰瘍形成
ulcerative pseudomembranous stomatitis	潰瘍性偽膜性口内炎
ulnar neuropathy	尺骨神経障害
ulodermatitis	瘢痕皮膚炎
umbilical granuloma	臍肉芽腫
umbilical hemorrhage	臍出血
umbilical hernia	臍ヘルニア
uncinariasis	鈎虫症
undernutrition	低栄養
underventilation	低換気∥呼吸低下(hypoventilation)
undescended testis	停留睾丸∥停留精巣(retained testis; retentio testis[L]; cryptorchidism)
upper abdominal pain	上腹部痛
upper airway obstruction	上気道閉塞
urarthritis	尿酸性関節炎
uratoma	尿酸塩腫
uremia	尿毒症
ureteral injury	尿管損傷
ureteral obstruction	尿管閉鎖
ureteralgia	尿管痛
ureterectasis	尿管拡張(症)
ureteritis	尿管炎
ureterocele	尿管瘤
ureterodialysis	尿管破裂
ureterolith	尿管結石
ureterolithiasis	尿管結石症
ureterolysis	1.尿管破裂; 2.尿管麻痺; 3.癒着尿管剥離
ureteropathy	尿管疾患
ureteropyelitis	尿管腎盂炎
ureteropyelonephritis	尿管腎盂腎炎
ureteropyosis	尿管化膿(症)
ureterorrhagia	尿管出血
ureterostenosis	尿管狭窄(症)
urethral dilation	尿道拡張
urethral injury	尿道損傷
urethral obstruction	尿道閉塞
urethral rupture	尿道断裂∥尿道破裂 
urethralgia	尿道痛
urethritis	尿道炎
urethrodynia	尿道痛
uricemia	尿酸血症
uricosuria	尿酸尿症
urina cruenta	血尿[L](=hematuria)
urobilinemia	ウロビリン血(症)
urocystitis	膀胱炎
urodynia	排尿痛
urolith	尿石
urolithiasis	尿石症
uteralgia	子宮痛(uterodynia)
uterine atony	子宮アトニー∥子宮弛緩(症)
uterine cervix cancer	子宮頚癌
uterine tetanus	#NAME?
uterine tetany	子宮痙攣
uterine polyp	子宮ポリープ
uterine leiomyoma	子宮平滑筋腫∥子宮筋腫
uterine hypertonia	子宮過度緊張∥子宮緊張亢進
uteritis	子宮炎
uterodynia	子宮痛(uteralgia)
uterolith	子宮結石
utriculitis	1.(内耳の卵形嚢炎; 2.前立腺小室炎
uveitis	ぶどう膜炎
uveoparotitic polyneuritis	ぶどう膜耳下腺性多発性神経炎
uvulitis	口蓋垂炎
vaginal atresia	膣閉鎖(症)(colpatresia)
vaginal laceration	腟裂傷
vaginitis	膣炎
vagitis	迷走神経炎
valvulitis	弁膜炎∥心弁膜炎
varicella	水痘(chickenpox)
varicosis	静脈瘤症
varicosity	静脈瘤様腫脹
variola	天然痘∥痘瘡(smallpox)
varix	静脈瘤
vasa previa	前置血管
vascular collapse	血管虚脱
vascular dementia	血管性痴呆
vascular edema	血管性水腫
vascular leiomyoma	血管平滑筋腫(angioleiomyoma) 
vascular nevus	血管性母斑
vascular obstruction	血管閉塞
vasculitis	血管炎∥脈管炎(angiitis)
vasoneurosis	血管神経症
vegetative endocarditis	増殖性心内膜炎
vegetative neurosis	自律神経症
venosclerosis	静脈硬化症
venostasis	静脈鬱血
ventricular dysfunction	心室機能不全
ventricular septal defect	心室中隔欠損症(略 VSD)
ventriculitis	脳室炎
venulitis	細静脈炎
verumontanitis	精丘炎
verruca vulgaris	尋常性疣贅[L]
verruciform xanthoma	疣贅型黄色腫
vertigo	眩暈=めまい//
vestibulitis	前庭炎
vilitigo vulgaris	尋常性白斑
villoma	絨毛腫
villous tumor	絨毛腫(villoma)
viral conjunctivitis	ウイルス性結膜炎
viral encephalomyelitis	ウイルス性脳脊髄炎
viral enteritis	ウイルス性腸炎
viral meningitis	ウイルス性髄膜炎
viremia	ウイルス血症
visceral crisis	内臓発症
visceral ectopia	内臓転位(症)
visceral pain	内臓痛(visceralgia)
visceral rheumatism	内臓リウマチ
visceralgia	内臓痛(visceral pain)
vitreous clouding	硝子体混濁(opacity of vitreous body)
vocal-cord adduction	声帯内転
volvulus	腸捻転
vomiting	嘔吐
vulgar ecthyma	尋常性膿瘡
vulvitis	外陰炎
wandering abscess	遊走性膿瘍
wandering pain	遊走痛
war neurosis	戦争神経症(combat neurosis)
Warthin tumor	ワルシン腫瘍(adenolymphoma)
weakness	衰弱
wet beriberi	湿性脚気
wet hoarseness	湿性嗄声
white coat hypertension	白衣高血圧
white diarrhea	白色下痢∥白痢
white hairy tongue	白色毛状舌
white spongy nevus	白色海綿状母斑
whoop	レプリーゼ
whooping cough	百日咳(pertussis)
Wilms' tumor	ウイルムス腫瘍
Wilson's disease	ウイルソン病
Wiskott-Aldrich syndrome	ウィスコット-アルドリック症候群
wrist joint pain	手関節痛
xanthofibroma	黄色線維腫
xanthogranuloma	黄色肉芽腫
xanthoma	黄色腫
xanthomatosis	黄色腫症
xerasia	毛髪乾燥症
xeroderma	乾皮症
xeroderma pigmentosum	色素性乾皮症
xerophthalmia	眼球乾燥症
xerosis cutis	乾皮症∥乾燥皮膚∥皮膚乾燥(症)(dry skin//xeroderma//xerodermia)
xerostomia	口腔乾燥症
xerotic keratitis	乾性角膜炎
xiphoiditis	剣状突起炎
xiphopagus	剣状突起結合体
yaw	イチゴ腫
yellow fever	黄熱病
yellow atrophy of liver	肝黄色萎縮
Yersinia infection	エルシニア感染症(acute mesenteric lymphadenitis)
Zenker's waxy degeneration	ツェンカー蝋変性
zoonosis	人畜共通感染症
zygomycosis	接合菌症
abdominal aorta aneurysm	腹部大動脈瘤
adrenopathy	副腎疾患
asynchronism	非同時性∥非同期∥異期
cholesteremia	高コレステロール血症
endogenous infection	内因性感染
exophthalmos	眼球突出(症)(proptosis)
flatulency	膨満∥鼓腸
leuconychia	爪甲白斑(症)
lung neoplasm	肺腫瘍
putaminal bleeding	被殻出血
pyorrhoea	膿漏(症)
scaphocephalism	舟状頭症∥舟状頭蓋奇形
tracheopathia	気管疾患
abnormally excessive sweating
bartholin's abscess
absence seizure
ac joint separation
achalasia
achilles tendinitis
achilles tendon rupture
acid reflux
infant acid reflux
acl injury
acquired immunodeficiency syndrome
acromioclavicular joint separation
acute coronary syndrome
acute febrile neutrophilic dermatosis
acute inflammatory demyelinating polyneuropathy
acute kidney failure
acute liver failure
acute lymphoblastic leukemia
acute lymphocytic leukemia
acute lymphoid leukemia
acute radiation sickness
acute radiation syndrome
acute renal failure
alcohol addiction
drug addiction
gambling addiction
nicotine addiction
mesenteric adenitis
adhd in children
adult adhd
adhesive capsulitis
adjustment disorders
adnexal tumors
adolescent schizophrenia
adrenal cancer
adrenal gland tumor
adrenal mass
adrenoleukodystrophy
adult attention-deficit/hyperactivity disorder
adult still's disease
age spots
dry age-related macular degeneration
wet age-related macular degeneration
agnogenic myeloid metaplasia
agoraphobia
aids/hiv
airplane ear
albinism
alcohol addiction
alcohol intolerance
alcohol poisoning
alcohol use disorder
alcohol-related birth defects
alcohol-related neurodevelopmental disorder
aldosteronoma
allergic granulomatosis
allergic granulomatosis and angiitis
allergic rhinitis
allergies
dustmite allergy
egg allergy
milk allergy
mold allergy
nickel allergy
peanut allergy
penicillin allergy
pet allergy
shellfish allergy
soy allergy
wheat allergy
alopecia
alpha-gal syndrome
alveolar osteitis
ambiguous genitalia
amblyopia
american trypanosomiasis
amnesia
dissociative amnesia
transientglobal amnesia
amnestic syndrome
amniotic fluid embolism
ampullary cancer
amyotrophic lateral sclerosis
anal cancer
anal itching
anaplasmosis
cooley's anemia
irondeficiency anemia
mediterranean anemia
sicklecell anemia
vitamindeficiency anemia
abdominalaortic aneurysm
brain aneurysm
cerebral aneurysm
popliteal aneurysm
thoracicaortic aneurysm
aneurysms
angelman syndrome
angiitis
angina
angina pectoris
angioedema and hives
angiofollicular lymph node hyperplasia
anhidrosis
ankle fracture
ankle sprain
ankyloglossia
anorexia
anorexia nervosa
anorgasmia in women
anterior cruciate ligament injury
anterior prolapse
antibiotic-associated colitis
antibiotic-associated diarrhea
antiphospholipid syndrome
antisocial personality disorder
generalized anxiety disorder
social anxiety disorder
anxiety disorders
aortic coarctation
aortic dissection
aortic valve disease
aortic valve regurgitation
aortic valve stenosis
primaryprogressive aphasia
aphthous ulcer
apical ballooning syndrome
arenaviruses
argentine hemorrhagic fever
arm fracture
arrhythmia
arteriosclerosis / atherosclerosis
arteriovenous fistula
arteriovenous malformation
giantcell arteritis
takayasu's arteritis
basaljoint arthritis
degenerative arthritis
juvenileidiopathic arthritis
osteoarthritis arthritis
psoriatic arthritis
reactive arthritis
septic arthritis
thumb arthritis
ascariasis
asthma attack
exercise-induced asthma
occupational asthma
atherosclerosis
athlete's foot
atopic dermatitis
atrial fibrillation
atrial flutter
atrial tachycardia
atrioventricular canal defect
atrioventricular nodal reentry tachycardia
atrioventricular septal defect
atrophic vaginitis
attachment disorder
attention-deficit/hyperactivity disorder
attention-deficit/hyperactivity disorder in adults
atypical depression
atypical hyperplasia of the breast
autism spectrum disorder
autoimmune pancreatitis
autonomic neuropathy
avascular necrosis
avian influenza
avnrt
baby acne
back pain
bags under eyes
baker's cyst
balance problems
baldness
barber's itch
barlow's syndrome
barotitis media
barotrauma
barrett's esophagus
bartholin's cyst
basal joint arthritis
bedbugs
bedsores
bed-wetting
bee sting
behcet's disease
bell's palsy
benign adrenal tumors
benign migratory glossitis
benign paroxysmal positional vertigo
benign peripheral nerve tumor
benign prostatic hyperplasia
berger's disease
bicuspid aortic valve
bile duct cancer
bile reflux
binge drinking
binge-eating disorder
bipolar disorder
bird flu
black hairy tongue
blackheads
bladder calculi
bladder cancer
lossof bladder control
bladder exstrophy
bladder infection
bladder inflammation
bladder prolapse
bladder stones
blastocystis hominis
blind loop syndrome
blocked tear duct
blood in urine
high blood pressure
low blood pressure
body dysmorphic disorder
body lice
body odor and sweating
boils and carbuncles
bone cancer
bone infection
bone metastasis
bone spurs
borderline personality disorder
botulism
bowel incontinence
bowel obstruction
brachial plexus injury
bradycardia-tachycardia syndrome
brain arteriovenous malformation
brain attack
brain avm
brain metastases
brain tumor
child brain tumor
inflammatory breast cancer
male breast cancer
breast cysts
breast infection
breast pain
broken ankle
broken arm
broken blood vessel in eye
broken collarbone
broken foot
broken hand
broken heart syndrome
broken hip
broken leg
broken nose
broken ribs
broken toe
broken wrist
brucellosis
brugada syndrome
bruxism
buerger's disease
bulimia nervosa
bundle branch block
bunions
bunyaviruses
burn injury
burning mouth syndrome
burning thigh pain
burns
bursitis of the knee
c. difficile colitis
c. difficile infection
calciphylaxis
calluses and corns
acute lymphocytic leukemia
acute myelogenous leukemia
basal cell
carcinoid tumors
cervical cancer
chronic lymphocytic leukemia
chronic myelogenous leukemia
colon cancer
endometrial cancer
esophageal cancer
eye melanoma cancer
gastric cancer
hairy cell leukemia
hodgkin's disease
hurthle cell thyroid cancer
inflammatory breast cancer
kidney cancer
lip cancer
male breast cancer
merkel cell cancer
mesothelioma cancer
mouth cancer
multiple myeloma cancer
nasopharyngeal cancer
neuroblastoma cancer
non-hodgkin's lymphoma cancer
oral cancer
ovarian cancer
pancreatic cancer
paraneoplastic syndromes
prostate cancer
rectal cancer
retinoblastoma
soft tissue sarcoma
squamous cell cancer
stomach cancer
testicular cancer
throat cancer
thyroid cancer
uterine cancer
vagina cancer
vulvar cancer
wilms'tumor
oral candidiasis
vaginal candidiasis
carbon monoxide poisoning
carbuncles and boils
carcinoid syndrome
carcinoid tumors
carcinoma of unknown primary
sudden cardiac arrest
cardiac ischemia
cardiomegaly
dilated cardiomyopathy
cardiovascular disease
carotid artery disease
castleman disease
cataracts
cavernous malformations
cavities/tooth decay
celiac disease
cellulite
central nervous system vascular malformations
cercarial dermatitis
cerebral aneurysm
cerebral palsy
cerumen impaction
cervical dystonia
cervical osteoarthritis
cervical spondylosis
chagas disease
charcot-marie-tooth disease
chemical dependency
chemo brain
chest wall pain
chiari malformation
chilblains
child abuse
child maltreatment
childhood apraxia of speech
childhood obesity
childhood schizophrenia
chlamydia trachomatis
cholangiocarcinoma
primarysclerosing cholangitis
cholestasis of pregnancy
highblood cholesterol
chordoma
huntington's chorea
choroid plexus carcinoma
chronic adrenal insufficiency
chronic cough
chronic daily headaches
chronic exertional compartment syndrome
chronic fatigue syndrome
chronic granulomatous disease
chronic hives
chronic kidney disease
chronic kidney failure
chronic lymphocytic thyroiditis
chronic obstructive pulmonary disease
chronic pelvic pain in women
chronic renal failure
chronic sinusitis
chronic traumatic encephalopathy
chronic vulvar pain
churg-strauss syndrome
cleft lip and cleft palate
click-murmur syndrome
clinical depression
clubfoot
cluster headache
coarctation of the aorta
coccidioidomycosis
cold allergy
cold exposure
cold sore
cold urticaria
common cold
ischemic colitis
microscopic colitis
collapsed lung
colon polyps
colonic ischemia
colorblindness
colorectal cancer
common cold in babies
common variable immunodeficiency
common variable immunodeficiency 
common warts
chronicexertional compartment syndrome
complex regional pain syndrome
complicated bereavement
complicated grief
compulsive gambling
compulsive hoarding syndrome
compulsive overeating
compulsive sexual behavior
compulsive stealing
concussion
condylomata acuminata
congenital adrenal hyperplasia
congenital heart defects in children
congenital heart disease in adults
congenital hip dislocation
congenital megacolon
congenital mitral valve anomalies
congenital myasthenic syndromes
congenital myopathies
congestive heart failure
conjoined twins
conjunctivitis
conn's syndrome
constipation in children
convergence insufficiency
cooley's anemia
corns and calluses
coronary artery disease
coronary microvascular disease
corticobasal degeneration
costochondritis
costosternal chondrodynia
costosternal syndrome
cough headaches
crabs
cradle cap
muscle cramp
menstrual cramps
cranial arteritis
creutzfeldt-jakob disease
crib death
crohn's disease
croup
cryptorchidism
cryptosporidiosis
cryptosporidium infection
curvature of the penis
curvature of the spine
cushing syndrome
cutaneous b-cell lymphoma
cutaneous t-cell lymphoma
cutting/self-injury
cyclic vomiting syndrome
cyclospora infection
cyclothymia
cyclothymic disorder
ganglion cyst
kidney cyst
ovarian cyst
pancreatic cyst
pilonidal cyst
spermatic cyst
epidermoid cysts
sebaceous cysts
cytomegalovirus
cytomegalovirus infection
dandruff
daytime sleepiness
de quervain's tenosynovitis
decreased tear production
deep vein thrombosis
deer-fly fever
degenerative arthritis
delayed ejaculation
delayed gastric emptying
delayed sleep phase
delirium
alzheimer'sdisease dementia
frontotemporal dementia
lewybody dementia
dengue fever
dengue hemorrhagic fever
nicotine dependence
dependent personality disorder
depersonalization disorder
depersonalization-derealization disorder
depression
inteenagers depression
cercarial dermatitis
scratch dermatitis
dermatographia
dermatophytosis
desmoid tumors
desmoplastic small round cell tumors
detached retina
developmental dysplasia of the hip
deviated septum
diabetes
gestational diabetes
hypoglycemia diabetes
type1 diabetes
type1inchildren diabetes
type2 diabetes
type2inchildren diabetes
diabetic hyperosmolar syndrome
diabetic hypoglycemia
diabetic ketoacidosis
diaper rash
traveler's diarrhea
difficulty focusing eyes
difficulty speaking
difficulty swallowing
diffuse idiopathic skeletal hyperostosis
digeorge syndrome
dislocated elbow
dislocated shoulder
dissecting aneurysm
dissociative disorders
double uterus
double-outlet right ventricle
down syndrome
dressler's syndrome
drop foot
drug addiction
drug allergy
dry eyes
dry mouth
dry skin
dsrct
ductal carcinoma in situ
dumping syndrome
dupuytren's contracture
dural arteriovenous fistulas
dust mite allergy
dwarfism
dysarthria
dyshidrosis
dyslexia
dysmenorrhea
dyspareunia
dyspepsia
dysphonia
dysrhythmias
dysthymia
dystonia
e. coli
ear infection
outerear ear infection
ruptured eardrum
early puberty
earwax blockage
eating disorders
anorexia eating disorders
bingeeating eating disorders
bulimia eating disorders
ebola virus
ebola virus and marburg virus
ebstein anomaly
ectopic heartbeat
ectropion
eczema
dyshidrotic eczema
ehlers-danlos syndrome
ehrlichiosis
eisenmenger syndrome
elevated blood pressure
embryonal tumors
encopresis
end stage renal disease
endocardial cushion defect
endometrial polyps
end-stage renal disease
enlarged breasts in men
enlarged heart
enlarged liver
enlarged prostate
enlarged spleen
enlarged thyroid
entropion
eosinophilic esophagitis
eosinophilic granulomatosis with polyangiitis 
lateral epicondylitis
epidural hematoma
frontallobe epilepsy
epithelioid sarcoma
erectile dysfunction
erythema infectiosum
erythema multiforme major
esophageal spasms
esophageal varices
essential tremor
esthesioneuroblastoma
ewing sarcoma
excess facial hair in women
excess growth hormone
excessive daytime sleepiness
excessive menstrual bleeding
exercise headaches
external compression headaches
external otitis
extrasystole
eye floaters
eye focusing
eye melanoma
eyelid inflammation
eyestrain
excessinwomen facial hair
facial palsy
factitious disorder
factor v leiden
fallen arches
tetralogyof fallot
familial adenomatous polyposis
familial hypercholesterolemia
familial mediterranean fever
familial paroxysmal peritonitis
farsightedness
febrile seizure
female infertility
female sexual dysfunction
fetal macrosomia
fever blister
valley fever
viralhemorrhagic fevers
fibrocystic breasts
fibromuscular dysplasia
interstitialpulmonary fibrosis
pulmonary fibrosis
fifth disease
filoviruses
flatfeet
flaviviruses
floaters
floor of the mouth cancer
floppy valve syndrome
avian flu
bird flu
swine flu
fluid around the heart
focal segmental glomerulosclerosis
folate deficiency anemia
egg food allergy
milk food allergy
food poisoning
food-borne illness
foot drop
foot fracture
foramen ovale
arm fracture
greenstick fracture
growthplate fracture
hip fracture
incomplete fracture
leg fracture
fractured nose
fractured ribs
frontal lobe epilepsy
frontal lobe seizures
frontotemporal lobar degeneration
frostbite
frozen shoulder
fuchs' dystrophy
dissociative fugue
functional dyspepsia
functional neurologic disorders/conversion disorder
nail fungal infection
funnel chest
galactorrhea
gallbladder inflammation
gallstones
gas and gas pains
gastric cancer
delayed gastric emptying
rapid gastric emptying
viral gastroenteritis
gastroesophageal reflux
gastroesophageal reflux disease
gastrointestinal bleeding
gastrointestinal stromal tumor
gastroparesis
gaucher disease
genital herpes
genital warts
germ cell tumors
german measles
giant cell arteritis
giant lymph node hyperplasia
giardia infection
gilbert's syndrome
globoid cell leukodystrophy
glossodynia
glucocerebrosidase deficiency
gluten-sensitive enteropathy
golfer's elbow
gonorrhea
grand mal seizure
granulomatosis with polyangiitis
graves' disease
greenstick fractures
grief
gross hematuria
group b strep disease
growing pains
growth hormone excess
growth plate fractures
guillain-barr��ｽｩ syndrome
gingivitis gum disease
periodontitis gum disease
h1n1 flu
hair loss
hair-pulling disorder
hairy cell leukemia
hairy tongue
halitosis
hammertoe and mallet toe
hamstring injury
hand fracture
hand pain
hand-foot-and-mouth disease
hangovers
hantavirus pulmonary syndrome
hardening of the arteries
hashimoto's disease
hay fever
head and neck cancers
head lice
coma head trauma
chronicdaily headache
exercise headache
externalcompression headache
icecream headache
migraine headache
primarycough headache
sex headache
sinus headache
spinal headache
tension headache
thunderclap headache
headaches in children
health anxiety
heart arrhythmias
heart attack
heart defects in adults
heart disease
heart murmurs
heart palpitations
heart valve disease
heartburn
heartburn
heat exhaustion
heat rash
heatstroke
heavy menstrual periods
heel pain
helicobacter pylori
liver hemangioma
intracranial hematoma
hematuria
hemifacial spasm
hemolytic uremic syndrome
hemorrhoids
henoch-schonlein purpura
hepatitis a
hepatitis b
hepatitis c
hepatomegaly
hepatopulmonary syndrome
hereditary hemochromatosis
hereditary hemorrhagic telangiectasia
hereditary motor and sensory neuropathy
hereditary nonpolyposis colorectal cancer syndrome
hereditary progressive arthro-ophthalmopathy
inguinal hernia
herniated disk
herpes zoster
herpes zoster oticus
hiccups
high blood pressure
high blood pressure in children
secondary high blood pressure
high cholesterol
high-flow priapism
hilar cholangiocarcinoma
hip dysplasia
hip impingement
hip labral tear
hirschsprung's disease
histoplasmosis
hiv/aids
hives and angioedema
hoarding disorder
hoarse voice
hodgkin's disease
hodgkin's lymphoma
hordeolum
horner syndrome
horner-bernard syndrome
hot flashes
hpv infection
human immunodeficiency virus
human papillomavirus infection
hunchback
hunter syndrome
huntington's disease
hunt's syndrome
hurthle cell cancer
hutchinson-gilford progeria syndrome
hypercalcemia
hypercholesterolemia
hypercortisolism
hypereosinophilic syndrome
hyperglycemia in diabetes
hypermenorrhea
hyperopia
hyperoxaluria and oxalosis
hypersexuality
hypertension
pregnancy-related hypertension
pulmonary hypertension
hypoactive sexual desire disorder
hypochondria
hypohidrosis
hypohydration
hyponatremia
hypoparathyroidism
hypopituitarism
hypospadias
hypotension
ice cream headaches
ichthyosis vulgaris
dissociative identity disorder
idiopathic hypersomnia
idiopathic intracranial hypertension
idiopathic myelofibrosis
idiopathic toe walking
iga nephropathy
iga vasculitis
illness anxiety disorder
immune thrombocytopenia
immune thrombocytopenic purpura
impacted wisdom teeth
impotence
incompetent cervix
incomplete fracture
bowel incontinence
nighttime incontinence
indigestion
infant jaundice
infant reflux
infantile hemangioma
infectious arthritis
infectious diseases
infertility
male infertility
inflammatory bowel disease
influenza
avian influenza
h1n1 influenza
swineflu influenza
ingrown hair
ingrown toenails
inherited metabolic disorder
inherited metabolic disorders
insulin resistance syndrome
intermittent explosive disorder
interstitial lung disease
intestinal ischemia
intestinal lipodystrophy
intestinal obstruction
intracranial venous malformations
intraductal carcinoma
intrahepatic cholestasis of pregnancy
intraocular melanoma
intussusception
iron overload
irritable bowel syndrome
ischemic priapism
islet cell cancer
itchy skin
jaw tumors and cysts
jellyfish stings
jet lag disorder
jock itch
joint dislocation
jumper's knee
juvenile fibromyalgia
juvenile idiopathic arthritis
juvenile rheumatoid arthritis
juvenile schizophrenia
kawasaki disease
keratoconjunctivitis sicca
keratoconus
keratosis pilaris
kidney cysts
chronic kidney failure
kidney infection
kidney stones
kissing disease
klatskin tumor
kleptomania
klinefelter syndrome
klippel-trenaunay syndrome
knee bursitis
knee pain
jumper's knee
krabbe disease
lactase deficiency
lactation mastitis
lassa fever
lateral epicondylitis
lazy eye
lead poisoning
leg fracture
legg-calve-perthes disease
legionellosis
legionnaires' disease
solar lentigines
acutelymphocytic leukemia
acutemyelogenous leukemia
chroniclymphocytic leukemia
chronicmyelogenous leukemia
general leukemia
hairycell leukemia
lewy body dementia
lichen nitidus
oral lichen planus
lichen simplex chronicus
limited scleroderma
lip cancer
intestinal lipodystrophy
listeria infection
listeriosis
renal lithiasis
liver disease
liver spots
lobular carcinoma in situ
lockjaw
long qt syndrome
loss of bladder control
lou gehrig's disease
low blood pressure
low blood sugar
low body temperature
low sex drive in women
low sperm count
low testosterone
low-flow priapism
lung collapse
lupus
swollen lymph nodes
lymphadenitis
mesenteric lymphadenitis
hodgkin's lymphoma
non-hodgkin's lymphoma
lynch syndrome
dry macular degeneration
wet macular degeneration
mad cow disease
major depressive disorder
male hypogonadism
malignant mesothelioma
malignant peripheral nerve sheath tumors
mallet toe and hammertoe
mammary duct ectasia
manic-depressive illness
marburg virus
marfan syndrome
mastalgia
mcad deficiency
german measles
medial epicondylitis
medial tibial stress syndrome
medication overuse headaches
mediterranean anemia
megacolon
megaloblastic anemia
melanoma of the eye
meniere's disease
meniscus tear
excessive menstrual bleeding
mental illness
meralgia paresthetica
merkel cell carcinoma
mesenteric ischemia
metabolic syndrome
metachromatic leukodystrophy
metastatic brain cancer
methicillin-resistant staphylococcus aureus infection
microscopic hematuria
migraine with aura
mild cognitive impairment
milia
miliaria
milk intolerance
miscarriage
mitral valve disease
mitral valve prolapse
mitral valve regurgitation
mitral valve stenosis
mittelschmerz
mixed connective tissue disease
molar pregnancy
moles
molluscum contagiosum
monoclonal gammopathy of undetermined significance
mood disorders
morning sickness
morphea
morton's neuroma
mosquito bites
movement disorders
moyamoya disease
mrsa infection
mucocutaneous lymph node syndrome
mucopolysaccharidosis type ii
multiple endocrine neoplasia type 1
type1 multiple endocrine neoplasia
multiple personality disorder
multiple sclerosis
multiple system atrophy
mumps
muscle strains
muscular dystrophy
myelodysplastic syndromes
myocardial infarction
myocardial ischemia
myoclonus
myofascial pain syndrome
myopia
naegleria infection
nail fungus
narcissistic personality disorder
narcolepsy
nasal and paranasal tumors
nasal polyps
nasopharyngeal carcinoma
nearsightedness
neck pain
nephroblastoma
nephrogenic systemic fibrosis
nephrotic syndrome
paraneoplasticsyndromes nervous system
postherpetic neuralgia
trigeminal neuralgia
neurodermatitis
neuroendocrine carcinoma of the skin
neuroendocrine tumors
plantar neuroma
neuromyelitis optica
hereditarymotorandsensory neuropathy
peripheral neuropathy
nevus
nicotine addiction
niemann-pick
nightmare disorder
nighttime incontinence
noctural enuresis
noise-related hearing loss
nonalcoholic fatty liver disease
nonallergic rhinitis
nonischemic priapism
nonmelanoma skin cancer
nontropical sprue
nonulcer dyspepsia
nonulcer stomach pain
noonan syndrome
norovirus infection
nose fracture
nymphomania
obsessive-compulsive disorder
obstetric cholestasis
obstructive sleep apnea in children
ocular albinism
ocular melanoma
ocular rosacea
oculocutaneous albinism
oculosympathetic palsy
odontogenic tumors and cysts
olfactory neuroblastoma
onychomycosis
oppositional defiant disorder
oral cancer
oral candidiasis
oral thrush
orthostatic hypotension
osgood-schlatter disease
cervical osteoarthritis
osteochondritis dissecans
osteonecrosis
osteophytes
otitis externa
otitis media
outer ear infection
ovarian cysts
ovarian hyperstimulation syndrome
overactive bladder
overactive thyroid
oxyphil cell carcinoma
paget's disease of bone
paget's disease of the breast
paget's disease of the nipple
wrist pain
painful bladder syndrome
painful intercourse
painful periods
facial palsy
progressivesupranuclear palsy
pancreatic cysts
panic attacks and panic disorder
papvr
paraneoplastic syndromes
paraneoplastic syndromes of the nervous system
paranoid personality disorder
paraplegia
parkinson's disease
parotid tumors
partial anomalous pulmonary venous connection
partial anomalous pulmonary venous return
parvovirus infection
patellar tendinitis
patellofemoral pain syndrome
patent ductus arteriosus
pathological gambling
pathological laughter and crying
pathological stealing
pectus carinatum
pediatric brain tumors
pediatric obstructive sleep apnea
pediatric thrombocytopenia
pediatric white blood cell disorders
pediculosis capitis
pelvic inflammatory disease
pelvic organ prolapse
chronic pelvic pain
uterineprolapse pelvic support problems
perforated eardrum
pericardial effusion
perimenopause
gingivitis periodontal disease
periodontitis periodontal disease
peripheral artery disease
peripheral nerve injuries
peripheral nerve tumors
peripheral vascular disease
pernicious anemia
pernio
peroneal muscular atrophy
persistent depressive disorder
schizoid personality disorder
schizotypal personality disorder
personality disorders
pertussis
pes planus
petit mal seizure
peyronie's disease
phantom pain
pharyngitis
phenylketonuria
phlebitis
social phobia
pick's disease
piles
pilonidal dimple
pimples
pinched nerve
pineoblastoma
pink eye
pinworm infection
pituitary insufficiency
pituitary tumors
pityriasis rosea
pityriasis versicolor
plague
plantar neuroma
plantar warts
poems syndrome
poison ivy rash
polio
polycystic kidney disease
polycystic ovary syndrome
polyhydramnios
polymorphous light eruption
polymyalgia rheumatica
endometrial polyps
stomach polyps
uterine polyps
pompholyx
poor color vision
popliteal artery aneurysm
popliteal artery entrapment
popliteal cyst
post-cardiac injury syndrome
post-chemotherapy cognitive impairment
post-concussion syndrome
posterior cortical atrophy
posterior cruciate ligament injury
posterior prolapse
posterior vaginal prolapse
postmyocardial infarction syndrome
postpartum hypopituitarism
postpartum preeclampsia
postpartum thyroiditis
post-polio syndrome
post-traumatic stress disorder
postural hypotension
prader-labhart-willi syndrome
prader-willi syndrome
precocious puberty
prediabetes
preeclampsia
preexcitation syndrome
pregnancy-related hypertension
premature birth
premature ejaculation
premature puberty
premature ventricular contractions
premenstrual syndrome
presbycusis
presbyopia
prescription drug abuse
pressure injury
pressure sores
pressure ulcer
preterm labor
priapism
prickly heat
primary adrenal insufficiency
primary aldosteronism
primary biliary cholangitis
primary biliary cirrhosis
primary hypoaldosteronism
primary immunodeficiency
primary lateral sclerosis
primary ovarian insufficiency
primary polycythemia
primary progressive aphasia
primary sclerosing cholangitis
proctitis
progressive supranuclear palsy
prolactinoma
mitralvalve prolapse
prolapsed bladder
prolapsed uterus
prostate gland enlargement
prostatitis
pruritis ani
pruritus
pseudobulbar affect
pseudocholinesterase deficiency
pseudotumor cerebri
psychosis
pubic lice
puffy eyes
pulmonary atresia
pulmonary atresia with intact ventricular septum
pulmonary atresia with ventricular septum defect
pulmonary valve disease
pulmonary valve stenosis
pyelonephritis
quadriplegia
query fever
rabbit fever
rabies
radiation enteritis
radiation sickness
ramsay hunt syndrome
rapid gastric emptying
rapid heartbeat
poisonivy rash
raynaud's disease
reactive attachment disorder
specific reading disability
rebound headache
rectal inflammation
rectal itching
rectal prolapse
rectal ulcer
rectovaginal fistula
recurrent breast cancer
red eye
gastroesophageal reflux
vesicoureteral reflux
aorticvalve regurgitation
mitralvalve regurgitation
reiter's syndrome
rem sleep behavior disorder
renal artery stenosis
renal cancer
renal lithiasis
residual limb pain
respiratory syncytial virus
restless legs syndrome
retinal detachment
retinal diseases
retractile testicle
retrograde ejaculation
rett syndrome
reye's syndrome
vasomotor rhinitis
rib fracture
rickets
rift valley fever
ringing in the ear
ringworm
ringworm of the foot
road rage
rocky mountain spotted fever
rosacea
roseola
rotator cuff injury
rotavirus
round back
rubeola
rumination syndrome
runner's knee
ruptured eardrum
ruptured spleen
sacral dimple
sacroiliitis
salivary gland tumors
salmonella infection
salmonellosis
bonecancer sarcoma
softtissue sarcoma
scabies
scalded mouth syndrome
scarlatina
schizoaffective disorder
schizophrenia
adolescent schizophrenia
juvenile schizophrenia
sclerosing cholangitis
sclerosing mesenteritis
amyotrophiclateral sclerosis
systemic sclerosis
scorpion sting
scrotal masses
seasonal affective disorder
seasonal allergy
sebaceous carcinoma
sebaceous cysts
secondary brain cancer
secondary hypertension
seizure disorder
grandmal seizure
petitmal seizure
temporallobe seizure
seizures
selective iga deficiency
self harming
self-injury/cutting
separated shoulder
separation anxiety disorder
atrioventricular septal defect
serotonin syndrome
severe acute respiratory syndrome
coma severe brain injury
sex headaches
sexual obsession
sexually transmitted diseases
shaken baby syndrome
sheehan's syndrome
shigella infection
shin splints
short bowel syndrome
shoulder dislocation
shoulder separation
shy-drager syndrome
sick sinus syndrome
sin nombre virus infection
sinus headaches
sjogren's syndrome
melanoma skin cancer
itchy skin
skipped heartbeats
slapped cheek disease
sleep apnea
obstructive sleep apnea in children
central sleep apnea
obstructive sleep apnea
sleep disorders
sleep terrors
daytime sleepiness
sleeplessness
sleep-related eating disorder
sleepwalking
slipped disk
slow heartbeat
small bowel cancer
small bowel prolapse
small intestine prolapse
small vessel disease
snoring
social anxiety disorder
soft palate cancer
soft tissue sarcoma
solar keratosis
solar lentigines
solitary fibrous tumor
solitary rectal ulcer syndrome
somatic symptom disorder
somnambulism
sore throat
spasmodic torticollis
specific phobias
specific reading disability
spider bites
spina bifida
spinal arteriovenous malformation
spinal cord injury
spinal cord tumor
spinal curvature
spinal headaches
splenomegaly
spontaneous coronary artery dissection
sprained ankle
sprains
squamous cell carcinoma of the skin
stable angina
stage 4 prostate cancer
stagnant syndrome
stammering
staph infections
statis syndrome
steele-richardson-olszewski syndrome
stein-leventhal syndrome
stenosing tenosynovitis
aorticvalve stenosis
mitralvalve stenosis
pulmonaryvalve stenosis
stevens-johnson syndrome
stickler syndrome
bee stings
scorpion stings
stomach flu
stomatodynia
stool holding
strawberry hemangioma
strep throat
stress cardiomyopathy
stress fractures
stress incontinence
stretch marks
stroke
stump pain
stuttering
subconjunctival hemorrhage
subdural hematoma
subfertility
sudden infant death syndrome
suicide
suicide and suicidal thoughts
sun allergy
sun poisoning
sunburn
sunken chest
suspicious breast lumps
sweating and body odor
abnormallyexcessive sweating
sweet's syndrome
swimmer's ear
swimmer's itch
swine flu
swollen knee
vasovagal syncope
syndrome x
synostosis
systemic capillary leak syndrome
systemic lupus erythematosus
systemic mastocytosis
systemic sclerosis
takotsubo cardiomyopathy
tapeworm infection
tapvr
tay-sachs disease
decreasedproduction tears
teen depression
teeth grinding
temporal arteritis
temporal lobe seizure
temporomandibular disorders
temporomandibular joint disorders
tennis elbow
dequervain's tenosynovitis
undescended testicle
testicular torsion
testosterone deficiency
tetraplegia
three-day measles
thromboangiitis obliterans
childhood thrombocytopenia
thunderclap headaches
thyroid gland enlargement
thyroid nodules
overactive thyroid
underactive thyroid
chroniclymphocytic thyroiditis
tic douloureux
tinea barbae
tinea capitis
tinea corporis
tinea cruris
tinea pedis
tinea versicolor
tmj disorders
toe walking in children
toenail fungus
tongue cancer
tongue tie
tongue-tie
tonic-clonic seizure
tonsil cancer
tooth abscess
tooth decay
torn meniscus
spasmodic torticollis
total anomalous pulmonary venous connection
total anomalous pulmonary venous return
tourette syndrome
toxemia
toxoplasmosis
trachoma
transient global amnesia
transient ischemic attack
transposition of great vessels
transposition of the great arteries
transverse myelitis
traumatic grief
trichinosis
trichomoniasis
trichotillomania
tricuspid atresia
tricuspid valve disease
tricuspid valve regurgitation
triple x syndrome
trisomy 21 syndrome
trisomy x
trouble swallowing
truncus arteriosus
american trypanosomiasis
tuberous sclerosis
salivarygland tumor
turner syndrome
type 1 diabetes
type 1 diabetes in children
type 2 diabetes
type 2 diabetes in children
typhoid fever
aphthous ulcer
ulnar wrist pain
uncontrollable laughter and crying
underactive thyroid
under-eye puffiness
undifferentiated pleomorphic sarcoma
unstable angina
upset stomach
ureteral cancer
urethral stricture
urinary tract infection
urine color
bloodin urine
urticaria
uterine cancer
uterine fibroids
uterine leiomyoma
uterine myoma
uterine prolapse
uterus didelphys
uveal melanoma
vaginal agenesis
vaginal atrophy
vaginal cancer
vaginal candidiasis
vaginal fistula
posterior vaginal prolapse
valvular heart disease
variant cjd
varicella
varicocele
varicose veins
variola
vascular rings
vasomotor rhinitis
velocardiofacial syndrome
venereal warts
venous thromboembolism
ventricular fibrillation
ventricular premature contraction
ventricular tachycardia
vertebral tumor
vertigo
vestibular schwannoma
v-fib
viral hemorrhagic fevers
vitamin deficiency anemia
vitiligo
vocal cord paralysis
vocal fold paralysis
voice disorders
von willebrand disease
vulvodynia
waldenstrom macroglobulinemia
venereal warts
water on the knee
wegener's granulomatosis
weight loss
wermer syndrome
wermer's syndrome
west nile virus
whiplash
whipple's disease
white blood cell disorders in children
whiteheads
wolff-parkinson-white
wrinkles
wrist fracture
syndrome x
xerosis
xerostomia
x-linked agammaglobulinemia
xxx syndrome
yeast infection
yersinia pestis
zika virus
zollinger-ellison syndrome
zoster
